阿=zshszhs
锕=phhhzzshszhs
嗄=szhhpszhhhpzd
啊=szhzshszhs
哎=szhhsspd
哀=dhszhpzpd
唉=szhzdphhpd
埃=hshzdphhpd
挨=hshzdphhpd
欸=zdphhpdpzpd
嗳=szhpddpdzhpzd
锿=phhhzdhszhpzpd
捱=hshhphshhsh
皑=pszhhszszhz
癌=dhpdhszhszhszhszs
毐=hshzzph
矮=phhpdphspdzph
蔼=hssdzszhhpzpdz
霭=hdzsdddddzszhhpzpdz
艾=hsspd
爱=pddpdzhpzd
砹=hpszhhsspd
隘=zsdphpdszssh
嗌=szhdphpdszssh
嫒=zphpddpdzhpzd
碍=hpszhszhhhhsd
叆=hhzdpddpdzhpzd
暧=szhhpddpdzhpzd
瑷=hhshpddpdzhpzd
安=ddzzph
桉=hspdddzzph
氨=phhzddzzph
庵=dhphpdszhhz
谙=dzdhdphszhh
鹌=hpdszhhzpzdzh
鞍=hsshszhhsddzzph
盦=pddzhszpzhhszssh
垵=hshddzzph
俺=pshpdszhhz
唵=szhhpdszhhz
埯=hshhpdszhhz
铵=phhhzddzzph
揞=hshdhdphszhh
犴=pzphhs
岸=szshphhs
按=hshddzzph
荌=hssddzzph
案=ddzzphhspd
胺=pzhhddzzph
暗=szhhdhdphszhh
黯=szdphshhdddddhdphszhh
肮=pzhhdhpz
卬=pzzs
昂=szhhpzzs
盎=szhpdszssh
凹=szszh
敖=hhshzpphpd
嗷=szhhhshzpphpd
嶅=hhshzpphpdszs
廒=dhphhshzpphpd
遨=hhshzpphpddzd
熬=hhshzpphpddddd
獒=hhshpzphpdhpdd
璈=hhshhhshzpphpd
翱=pszhhhpdhszdhzdh
聱=hhshzpphpdhsshhh
螯=hhshzpphpdszhshd
鳌=hhshzpphpdpzszhshh
鏖=dhpzsshhzpzpdhhsdph
拗=hshzzdzp
袄=dzspdphpd
媪=zphszhhszssh
岙=phpdszs
坳=hshzzdzp
垇=hshszszh
傲=pshhshzpphpd
奡=hpszhhhhpdps
奥=pszdphspdhpd
骜=hhshzpphpdzzh
隩=zspszdphspdhpd
懊=ddspszdphspdhpd
澳=ddhpszdphspdhpd
鏊=hhshzpphpdpdhhsdph
八=pd
巴=zshz
叭=szhpd
扒=hshpd
朳=hspdpd
岜=szszshz
芭=hsszshz
疤=dhpdhzshz
捌=hshszhzpss
笆=phdphdzshz
粑=dphspdzshz
羓=dphhhpzshz
蚆=szhshdzshz
鲃=pzszhshhzshz
妭=zphhpzdd
拔=hshhpzdd
胈=pzhhhpzdd
菝=hsshshhpzdd
跋=szhshshhpzdd
魃=pszhhpzzdhpzdd
把=hshzshz
钯=phhhzzshz
靶=hsshszhhszshz
坝=hshszpd
爸=pdpdzshz
罢=szsshhshzd
耙=hhhspdzshz
鲅=pzszhshhhpzdd
鲌=pzszhshhpszhh
霸=hdzsddddhsshszhhspzhh
灞=ddhhdzsddddhsshszhhspzhh
吧=szhzshz
掰=phhppdzpphhs
擘=zhpszhdhdphhsphhs
白=pszhh
百=hpszhh
佰=pshpszhh
柏=hspdpszhh
捭=hshpszhhphs
摆=hshszsshhshzd
败=szpdphpd
拜=phhphhhhs
稗=phspdpszhhphs
扳=hshppzd
攽=pdzpphpd
班=hhshdphhsh
般=ppzdhdpzzd
颁=pdzphpszpd
斑=hhshdhpdhhsh
搬=hshppzdhdpzzd
瘢=dhpdhppzdhdpzzd
癍=dhpdhhhshdhpdhhsh
阪=zsppzd
坂=hshppzd
昄=szhhppzd
板=hspdppzd
版=pshzppzd
钣=phhhzppzd
粄=dphspdppzd
办=zpdd
半=dphhs
伴=psdphhs
扮=hshpdzp
拌=hshdphhs
绊=zzhdphhs
柈=hspddphhs
湴=ddhdphssdph
靽=hsshszhhsdphhs
瓣=dhdphhpppzdddhdphhs
邦=hhhpzs
帮=hhhpzsszs
梆=hspdhhhpzs
浜=ddhpshshpd
绑=zzhhhhpzs
榜=hspddhdpdzdhzp
膀=pzhhdhdpdzdhzp
玤=hhshhhhs
蚌=szhshdhhhs
傍=psdhdpdzdhzp
棒=hspdhhhpdhhs
棓=hspddhdphszh
谤=dzdhdpdzdhzp
塝=hshdhdpdzdhzp
搒=hshdhdpdzdhzp
蒡=hssdhdpdzdhzp
磅=hpszhdhdpdzdhzp
镑=phhhzdhdpdzdhzp
包=pzzhz
孢=zshpzzhz
苞=hsspzzhz
枹=hspdpzzhz
胞=pzhhpzzhz
煲=psszhhspddppd
龅=shshpdzspzzhz
褒=dhpsszhhspdpzpd
雹=hdzsddddpzzhz
薄=hssddhhszhhsdhsd
宝=ddzhhshd
饱=pzzpzzhz
保=psszhhspd
鸨=pzhspzdzh
堡=psszhhspdhsh
葆=hsspsszhhspd
褓=dzspdpsszhhspd
报=hshzszd
抱=hshpzzhz
豹=pddpzpppzd
趵=szhshshpzd
鲍=pzszhshhpzzhz
暴=szhhhsshpdsdhpd
爆=dppdszhhhsshpdsdhpd
陂=zszpszd
卑=pszhhphs
杯=hspdhpsd
悲=shhhshhhdzdd
椑=hspdpszhhphs
碑=hpszhpszhhphs
鹎=pszhhphspzdzh
北=shhpz
贝=szpd
孛=hsdzzsh
狈=pzpszpd
邶=shhpzzs
备=pzdszhsh
背=shhpzszhh
钡=phhhzszpd
倍=psdhdphszh
悖=ddshsdzzsh
被=dzspdzpszd
惫=pzdszhshdzdd
焙=dppddhdphszh
琲=hhshshhhshhh
辈=shhhshhhhzhs
碚=hpszhdhdphszh
蓓=hsspsdhdphszh
褙=dzspdshhpzszhh
鞁=hsshszhhszpszd
糒=dphspdhsshpszhhs
鞴=hsshszhhshsshpszhhs
鐾=zhpszhdhdphhspdhhsdph
呗=szhszpd
奔=hpdhshps
贲=hshssszpd
栟=hspddphhps
犇=phhsphshphhs
锛=phhhzhpdhshps
本=hspdh
苯=hsshspdh
畚=zdhpdszhsh
坋=hshpdzp
坌=pdzphsh
倴=pshpdhshps
笨=phdphdhspdh
祊=dzsddhzp
崩=szspzhhpzhh
绷=zzhpzhhpzhh
嘣=szhszspzhhpzhh
甭=hpsdpzhhs
琫=hhshhhhpdhhs
泵=hpszhszpd
迸=dphhpsdzd
甏=hshszhdphppphzzd
镚=phhhzszspzhhpzhh
蹦=szhshshszspzhhpzhh
揼=hshhpszhszpd
屄=zhpddzpd
逼=hszhszhshdzd
鲾=pzszhshhhszhszhsh
荸=hsshsdzzsh
鼻=pszhhhszhshhps
匕=pz
比=hzpz
吡=szhhzpz
妣=zphhzpz
沘=ddhhzpz
彼=ppszpszd
秕=phspdhzpz
俾=pspszhhphs
笔=phdphdphhz
舭=ppzdhdhzpz
鄙=szhhsszszhhzs
币=pszs
必=dzdpd
毕=hzpzhs
闭=dszhsp
佖=psdzdpd
坒=hzpzhsh
庇=dhphzpz
诐=dzzpszd
邲=dzdpdzs
畀=szhshhps
苾=hssdzdpd
哔=szhhzpzhs
毖=hzpzdzdpd
珌=hhshdzdpd
荜=hsshzpzhs
陛=zshzpzhsh
毙=hzpzhpzdpz
狴=pzphzpzhsh
铋=phhhzdzdpd
婢=zphpszhhphs
庳=dhppszhhphs
敝=dpszspdphpd
萆=hsspszhhphs
弼=zhzhpszhhzhz
愎=ddsphszhhpzd
皕=hpszhhhpszhh
筚=phdphdhzpzhs
赑=szpdszpdszpd
滗=ddhphdphdphhz
痹=dhpdhszhshhps
蓖=hsspszpdhhzpz
裨=dzspdpszhhphs
跸=szhshshhzpzhs
弊=dpszspdphpdhps
碧=hhshpszhhhpszh
箅=phdphdszhshhps
蔽=hssdpszspdphpd
馝=phspdszhhdzdpd
壁=zhpszhdhdphhshsh
嬖=zhpszhdhdphhszph
篦=phdphdpszpdhhzpz
薜=hsszhpszhdhdphhs
觱=hphszhzpdpzpzhhs
避=zhpszhdhdphhsdzd
濞=ddhpszhhhszhshhps
臂=zhpszhdhdphhsszhh
髀=szzdzszhhpszhhphs
璧=zhpszhdhdphhshhshd
襞=zhpszhdhdphhsdhpzpd
边=zpdzd
砭=hpszhpdzd
笾=phdphdzpdzd
编=zzhdzhpszhss
煸=dppddzhpszhss
蝙=szhshddzhpszhss
鳊=pzszhshhdzhpszhss
鞭=hsshszhhspshszhhpd
贬=szpdpdzd
扁=dzhpszhss
匾=hdzhpszhssz
萹=hssdzhpszhss
碥=hpszhdzhpszhss
褊=dzspddzhpszhss
卞=dhsd
弁=zdhps
忭=ddsdhsd
抃=hshdhsd
汴=ddhdhsd
苄=hssdhsd
变=dhsspdzd
便=pshszhhpd
昪=szhhzdhps
遍=dzhpszhssdzd
辨=dhdphhpdpdhdphhs
辩=dhdphhpdzdhdphhs
辫=dhdphhpzzhdhdphhs
杓=hspdpzd
标=hspdhhspd
飑=pzpdpzzhz
骉=zzhzzhzzh
彪=shzphzpzppp
脿=pzhhhhshpzpd
幖=szshszsshhhspd
摽=hshhszsshhhspd
蔈=hsshszsshhhspd
骠=zzhhszsshhhspd
熛=dppdhszsshhhspd
膘=pzhhhszsshhhspd
瘭=dhpdhhszsshhhspd
镖=phhhzhszsshhhspd
飙=hpddhpddhpddpzpd
儦=psdhpzsshhzpzdddd
瀌=ddhdhpzsshhzpzdddd
藨=hssdhpzsshhzpzdddd
镳=phhhzdhpzsshhzpzdddd
表=hhshpzpd
婊=zphhhshpzpd
裱=dzspdhhshpzpd
俵=pshhshpzpd
鳔=pzszhshhhszsshhhspd
憋=dpszspdphpddzdd
鳖=dpszspdphpdpzszhshh
别=szhzpss
咇=szhdzdpd
蹩=dpszspdphpdszhshpd
瘪=dhpdhpszhhhpdpz
邠=pdzpzs
玢=hhshpdzp
宾=ddzpshshpd
彬=hspdhspdppp
傧=psddzpshshpd
斌=dhpdhhshshzd
滨=ddhddzpshshpd
缤=zzhddzpshshpd
槟=hspdddzpshshpd
镔=phhhzddzpshshpd
濒=ddhshshspphpszpd
豳=hpzpppdshpzpppdzs
摈=hshddzpshshpd
殡=hpzdddzpshshpd
膑=pzhhddzpshshpd
髌=szzdzszhhddzpshshpd
鬓=hshhhzdpppddzpshshpd
仌=pdpd
冰=dhszpd
兵=pshshpd
丙=hszpd
邴=hszpdzs
抦=hshhszpd
秉=phzhhspd
昺=szhhhszpd
柄=hspdhszpd
炳=dppdhszpd
饼=pzzdphhps
蛃=szhshdhszpd
摒=hshzhpdphhps
禀=dhszszhhhhspd
并=dphhps
病=dhpdhhszpd
拨=hshzpzdd
波=ddhzpszd
玻=hhshzpszd
剥=zhhsdhpdss
哱=szhhsdzzsh
砵=hpszhhspdh
钵=phhhzhspdh
饽=pzzhsdzzsh
啵=szhddhzpszd
菠=hssddhzpszd
嶓=szspdphspdszhsh
播=hshpdphspdszhsh
伯=pspszhh
驳=zzhpdpd
帛=pszhhszs
勃=hsdzzshzp
亳=dhszhdzphz
浡=ddhhsdzzsh
袯=dzspdzpzdd
钹=phhhzhpzdd
铂=phhhzpszhh
脖=pzhhhsdzzsh
舶=ppzdhdpszhh
博=hshszhhsdhsd
渤=ddhhsdzzshzp
鹁=hsdzzshpzdzh
搏=hshhszhhsdhsd
僰=hszspdhszspdpd
箔=phdphdddhpszhh
膊=pzhhhszhhsdhsd
踣=szhshshdhdphszh
镈=phhhzhszhhsdhsd
馞=phspdszhhhsdzzsh
欂=hspdhssddhhszhhsdhsd
礴=hpszhhssddhhszhhsdhsd
跛=szhshshzpszd
簸=phdphdhsshhhpdzpszd
檗=zhpszhdhdphhshspd
卜=sd
逋=hszhhsddzd
晡=szhhhszhhsd
醭=hszpzhhssdphdphhhpd
卟=szhsd
补=dzspdsd
哺=szhhszhhsd
捕=hshhszhhsd
不=hpsd
布=hpszs
步=shshspp
怖=ddshpszs
钚=phhhzhpsd
埔=hshhszhhsd
埗=hshshshspp
部=dhdphszhzs
埠=hshpszhzhhs
瓿=dhdphszhhzzd
蔀=hssdhdphszhzs
簿=phdphdddhhszhhsdhsd
嚓=szhddzpzddzdhhspd
擦=hshddzpzddzdhhspd
偲=psszhshdzdd
猜=pzphhshszhh
才=hsp
材=hspdhsp
财=szpdhsp
裁=hshdhpzpdzpd
采=pddphspd
彩=pddphspdppp
睬=szhhhpddphspd
踩=szhshshpddphspd
菜=hsspddphspd
蔡=hsspzddzdhhspd
参=zdhpdppp
骖=zzhzdhpdppp
喰=szhpddzhhzpd
餐=shpzdzdpddzhhzpd
残=hpzdhhzpd
蚕=hhpdszhshd
惭=ddshzshpphs
惨=ddszdhpdppp
黪=szdphshhddddzdhpdppp
灿=dppdszs
掺=hshzdhpdppp
孱=zhpzshzshzsh
粲=shpzdzddphspd
璨=hhshshpzdzddphspd
仓=pdzz
伧=pspdzz
沧=ddhpdzz
苍=hsspdzz
鸧=pdzzpzdzh
舱=ppzdhdpdzz
藏=hsshpzhphszhszzpd
操=hshszhszhszhhspd
糙=dphspdphshszhdzd
曹=hszhsshszhh
嘈=szhhszhsshszhh
漕=ddhhszhsshszhh
槽=hspdhszhsshszhh
艚=ppzdhdhszhsshszhh
螬=szhshdhszhsshszhh
草=hssszhhhs
肏=pdszpdpd
册=pzpzh
侧=psszpdss
厕=hpszpdss
恻=ddsszpdss
测=ddhszpdss
策=phdphdhszspd
岑=szspddz
涔=ddhszspddz
梣=hspdszspddz
噌=szhdpszsdphszhh
层=zhphhzd
曾=dpszsdphszhh
嶒=szsdpszsdphszhh
蹭=szhshshdpszsdphszhh
叉=zdd
杈=hspdzdd
插=hshphspshzhh
馇=pzzhspdszhhh
锸=phhhzphspshzhh
垞=hshddzphz
查=hspdszhhh
茬=hsshpshsh
茶=hsspdhspd
嵖=szshspdszhhh
搽=hshhsspdhspd
猹=pzphspdszhhh
槎=hspddphhhphsh
察=ddzpzddzdhhspd
碴=hpszhhspdszhhh
檫=hspdddzpzddzdhhspd
衩=dzspdzdd
蹅=szhshshhspdszhhh
镲=phhhzddzpzddzdhhspd
汊=ddhzdd
岔=pdzpszs
侘=psddzphz
诧=dzddzphz
姹=zphddzphz
差=dphhhphsh
拆=hshpphsd
钗=phhhzzdd
侪=psdhpdps
柴=shshpzhspd
豺=pddpzpphsp
茝=hsshsszhsz
虿=hzpszhshd
瘥=dhpdhdphhhphsh
辿=szsdzd
觇=shszhszpz
梴=hspdpshzzd
搀=hshpzszhpzdd
襜=dzspdpzhppddhhhszh
婵=zphdpszhhhs
谗=dzpzszhpzdd
禅=dzsddpszhhhs
馋=pzzpzszhpzdd
缠=zzhdhpszhhshh
僝=pszhpzshzshzsh
蝉=szhshddpszhhhs
廛=dhpszhhshhpdhsh
潺=ddhzhpzshzshzsh
澶=ddhdhszszhhszhhh
镡=phhhzhszsshszhhhs
瀍=ddhdhpszhhshhpdhsh
儳=pspzszhhzpzpzszhpzd
蟾=szhshdpzhppddhhhszh
巉=szspdszhhzpdpdszhpzd
躔=szhshshdhpszhhshhpdhsh
镵=phhhzpzszhhzpzpzszhpzd
产=dhdphp
刬=hhzpdss
旵=szhhszs
浐=ddhdhdphp
谄=dzpzpshzhh
啴=szhdpszhhhs
铲=phhhzdhdphp
阐=dszdpszhhhs
蒇=hsshpszpdzpd
骣=zzhzhpzshzshzsh
冁=dpszhhhszhphsshzpd
忏=ddsphs
颤=dhszszhhszhhhhpszpd
羼=zhpdphhhsdphhhpdphhhs
韂=hsshszhhspzhppddhhhszh
伥=psphzd
昌=szhhszhh
娼=zphszhhszhh
猖=pzpszhhszhh
菖=hssszhhszhh
阊=dszszhhszhh
鲳=pzszhshhszhhszhh
肠=pzhhzpp
苌=hssphzd
尝=sdpdzhhzd
偿=pssdpdzhhzd
常=sdpdzszhszs
徜=ppssdpszszh
嫦=zphsdpdzszhszs
鲿=pzszhshhsdpdzhhzd
厂=hp
场=hshzpp
昶=dzzpdszhh
惝=ddssdpszszh
敞=sdpszszhphpd
氅=sdpszszhphpdphhz
怅=ddsphzd
玚=hhshzpp
畅=szhhszpp
倡=psszhhszhh
鬯=pdddddzspz
唱=szhszhhszhh
抄=hshspdp
弨=zhzzpszh
怊=ddszpszh
钞=phhhzspdp
焯=dppdshszhhhs
超=hshshpdzpszh
晁=szhhpdhzpd
巢=zzzszhhhspd
朝=hsszhhhspzhh
嘲=szhhsszhhhspzhh
潮=ddhhsszhhhspzhh
吵=szhspdp
炒=dppdspdp
耖=hhhspdspdp
车=hzhs
車=hszhhhs
砗=hpszhhzhs
唓=szhhszhhhs
扯=hshshsh
彻=ppshzzp
坼=hshpphsd
掣=phhszsssphhs
撤=hshdhzdszhhphpd
澈=ddhdhzdszhhphpd
抻=hshszhhs
郴=hspdhspdzs
琛=hhshdzpdhspd
嗔=szhhsszhhhhpd
瞋=szhhhhsszhhhhpd
尘=spdhsh
臣=hszhsz
忱=ddsdzpz
沉=ddhdzpz
辰=hphhzpd
陈=zshzspd
宸=ddzhphhzpd
莀=hsshphhzpd
晨=szhhhphhzpd
谌=dzhsshhhpdz
煁=dppdhsshhhpdz
碜=hpszhzdhpdppp
衬=dzspdhsd
疢=dhpdhdppd
龀=shshpdzspz
趁=hshshpdpdppp
榇=hspddhdphhspd
谶=dzpdpdhshhhshhhhzpd
柽=hspdzdhsh
琤=hhshpzzhhs
称=phspdpzspd
偁=pspddpszshh
蛏=szhshdzdhsh
牚=sdpdzszhhzsp
赪=hshpspdshszpd
撑=hshsdpdzszhphhs
瞠=szhhhsdpdzszhhsh
丞=zszpdh
成=hpzzpd
呈=szhhhsh
承=zshhhzpd
枨=hspdphzd
诚=dzhpzzpd
城=hshhpzzpd
宬=ddzhpzzpd
乘=phsshhpzpd
埕=hshszhhhsh
晟=szhhhpzzpd
珹=hhshhpzzpd
珵=hhshszhhhsh
铖=phhhzhpzzpd
惩=ppshshshdzdd
程=phspdszhhhsh
裎=dzspdszhhhsh
塍=szhhdphhpdhsh
酲=hszpzhhszhhhsh
憕=ddszdppdhszhdph
澂=ddhszshhhshphpd
澄=ddhzdppdhszhdph
橙=hspdzdppdhszhdph
逞=szhhhshdzd
骋=zzhszhshhz
庱=dhphshpdpzd
秤=phspdhdphs
吃=szhphz
哧=szhhshpspd
蚩=zsshszhshd
鸱=pzhzdpzdzh
瓻=pdhpszshzzd
眵=szhhhpzdpzd
笞=phdphdzdszh
嗤=szhzsshszhshd
媸=zphzsshszhshd
摛=hshdhpdzsszzd
痴=dhpdhphhpdszh
螭=szhshddhpdzsszzd
魑=pszhhpzzddhpdzsszzd
弛=zhzzsz
池=ddhzsz
驰=zzhzsz
迟=zhpddzd
坻=hshpzhzd
茌=hsspshsh
持=hshhshhsd
墀=hshzhpsdhpdphhs
漦=hhspdphpdhpszpd
踟=szhshshphhpdszh
篪=phdphdppshzphzpz
尺=zhpd
侈=pspzdpzd
齿=shshpdzs
胣=pzhhphzsz
耻=hsshhhshsh
褫=dzspdppshzphzpz
彳=pps
叱=szhpz
斥=pphsd
赤=hshpspd
饬=pzzphzp
炽=dppdszhpd
翅=hszdzdhzdh
敕=hszhspdphpd
痓=dhpdhhzdhsh
啻=dhdpdzszsszh
傺=pspzddzdhhspd
瘛=dhpdhhhhszpdzdd
充=dhzdpz
冲=dhszhs
忡=ddsszhs
茺=hssdhzdpz
珫=hhshdhzdpz
翀=zdhzdhszhs
舂=hhhpdpshzhh
摏=hshhhhpdpshzhh
憧=ddsdhdphszhhshh
艟=ppzdhddhdphszhhshh
虫=szhshd
崇=szsddzhhspd
宠=ddzhpzpd
埫=hshsdpszszh
铳=phhhzdhzdpz
抽=hshszhsh
婤=zphpzhshszh
瘳=dhpdhzdhzdhpdppp
犨=psdhhhshpsdhhhshphhs
仇=pspz
俦=pshhhphsd
帱=szshhhphsd
惆=ddspzhshszh
绸=zzhpzhshszh
椆=hspdpzhshszh
畴=szhshhhhphsd
愁=phspddppddzdd
稠=phspdpzhshszh
筹=phdphdhhhphsd
酬=hszpzhhdpdsds
踌=szhshshhhhphsd
雠=psdhhhshdzpsdhhhsh
丑=zshh
杻=hspdzshh
侴=pdhzshhss
瞅=szhhhphspddppd
臭=pszhhhhpdd
出=zsszs
初=dzspdzp
摴=hshhdzsddddhhz
樗=hspdhdzsddddhhz
刍=pzzhh
除=zspdhhspd
厨=hphszhdphhsd
滁=ddhzspdhhspd
锄=phhhzszhhhzp
蜍=szhshdpdhhspd
雏=pzzhhpsdhhhsh
橱=hspdhphszhdphhsd
躇=szhshshhsshshpszhh
蹰=szhshshhphszhdphhsd
杵=hspdphhs
础=hpszhzsszs
储=psdzhshpszhh
楮=hspdhshpszhh
楚=hspdhspdzshpd
褚=dzspdhshpszhh
濋=ddhhspdhspdzshpd
亍=hhs
处=pzdsd
怵=ddshspdd
绌=zzhzsszs
柷=hspdszhpz
俶=psshhspdzd
畜=dhzzdszhsh
琡=hhshshhspdzd
搐=hshdhzzdszhsh
触=pzpzhhsszhshd
憷=ddshspdhspdzshpd
斶=pphsszsshpzszhshd
黜=szdphshhddddzsszs
矗=hsszhhhhhsszhhhhhsszhhhh
欻=dppddppdpzpd
揣=hshszshpszss
搋=hshppshzphzpz
啜=szhzdzdzdzd
嘬=szhszhhhsshhhzd
踹=szhshshszshpszss
川=pss
氚=phhzpss
穿=ddzpdhzsp
传=pshhzd
船=ppzdhdpzszh
圌=szszshpszssh
遄=szshpszssdzd
椽=hspdzzhpzpppd
舛=pzdhzs
喘=szhszshpszss
串=szhszhs
钏=phhhzpss
疮=dhpdhpdzz
窗=ddzpdpszpzdh
床=dhphspd
噇=szhdhdphszhhshh
幢=szsdhdphszhhshh
闯=dszzzh
创=pdzzss
怆=ddspdzz
吹=szhpzpd
炊=dppdpzpd
垂=phshsshh
倕=psphshsshh
陲=zsphshsshh
捶=hshphshsshh
棰=hspdphshsshh
椎=hspdpsdhhhsh
槌=hspdpszhzhdzd
锤=phhhzphshsshh
春=hhhpdszhh
堾=hshhhhpdszhh
椿=hspdhhhpdszhh
瑃=hhshhhhpdszhh
蝽=szhshdhhhpdszhh
纯=zzhhzsz
唇=hphhzpdszh
莼=hsszzhhzsz
淳=ddhdhszhzsh
鹑=dhszhzshpzdzh
醇=hszpzhhdhszhzsh
蠢=hhhpdszhhszhshdszhshd
逴=shszhhhsdzd
踔=szhshshshszhhhs
戳=zdhzdhpsdhhhshhzpd
婼=zphhsshpszh
惙=ddszdzdzdzd
绰=zzhshszhhhs
辍=hzshzdzdzdzd
龊=shshpdzsszhshpd
呲=szhshshpz
疵=dhpdhshshpz
跐=szhshshshshpz
词=dzzhszh
祠=dzsdzhszh
茈=hssshshpz
茨=hssdhpzpd
堲=zhhzdzshsh
瓷=dhpzpdhzzd
慈=dphzzdzzddzdd
辞=phsszhdhdphhs
磁=hpszhdphzzdzzd
雌=shshpzpsdhhhsh
鹚=dphzzdzzdpzdzh
糍=dphspddphzzdzzd
此=shshpz
泚=ddhshshpz
玼=hhshshshpz
次=dhpzpd
伺=pszhszh
佽=psdhpzpd
刺=hszspdss
莿=hsshszspdss
赐=szpdszhhpzpp
匆=pzppd
囱=pszpzdh
苁=hsspdpd
枞=hspdpdpd
葱=hsspzppddzdd
骢=zzhpszpzdhdzdd
熜=dppdpszpzdhdzdd
璁=hhshpszpzdhdzdd
聪=hsshhhdpszhdzdd
从=pdpd
丛=pdpdh
悰=ddsddzhhspd
淙=ddhddzhhspd
琮=hhshddzhhspd
凑=dhhhhpdhhpd
腠=pzhhhhhpdhhpd
辏=hzshhhhpdhhpd
粗=dphspdszhhh
麤=dhpzsshhzpzdhpzsshhzpzdhpzsshhzpz
徂=ppsszhhh
殂=hpzdszhhh
促=psszhshpd
猝=pzpdhpdpdhs
酢=hszpzhhphshh
蔟=hssdhzpphphhpd
醋=hszpzhhhsshszhh
簇=phdphddhzpphphhpd
蹙=hpshhspdzpdszhshpd
蹴=szhshshdhszhspdhpzd
汆=pdszpd
撺=hshddzpdszhszhs
镩=phhhzddzpdszhszhs
蹿=szhshshddzpdszhszhs
窜=ddzpdszhszhs
篡=phdphdszhhhhpdzd
爨=pshhszhszhzhhdzhspdhspdhpddppd
崔=szspsdhhhsh
催=psszspsdhhhsh
缞=zzhdhszhhpzpd
摧=hshszspsdhhhsh
榱=hspddhszhhpzpd
漼=ddhszspsdhhhsh
璀=hhshszspsdhhhsh
脆=pzhhpzhpzz
啐=szhdhpdpdhs
悴=ddsdhpdpdhs
淬=ddhdhpdpdhs
萃=hssdhpdpdhs
毳=phhzphhzphhz
瘁=dhpdhdhpdpdhs
粹=dphspddhpdpdhs
翠=zdhzdhdhpdpdhs
邨=hzszzs
村=hspdhsd
皴=zdpdpzdzpszd
存=hpszsh
忖=ddshsd
寸=hsd
搓=hshdphhhphsh
瑳=hhshdphhhphsh
磋=hpszhdphhhphsh
撮=hshszhhhsshhhzd
蹉=szhshshdphhhphsh
嵯=szsdphhhphsh
痤=dhpdhpdpdhsh
矬=phhpdpdpdhsh
鹾=shszpdhdphhhphsh
酂=phshpzphshpzszpdzs
脞=pzhhpdpdhsh
厝=hphsshszhh
挫=hshpdpdhsh
莝=hsspdpdhsh
措=hshhsshszhh
棤=hspdhsshszhh
锉=phhhzpdpdhsh
错=phhhzhsshszhh
耷=hpdhsshhh
嗒=szhhsspdhszh
搭=hshhsspdhszh
褡=dzspdhsspdhszh
达=hpddzd
妲=zphszhhh
怛=ddsszhhh
沓=szpdszhh
哒=szhhpddzd
炟=dppdszhhh
荙=hsshpddzd
笪=phdphdszhhh
答=phdphdpdhszh
跶=szhshshhpddzd
阘=dszszhhzdhzdh
靼=hsshszhhsszhhh
鞑=hsshszhhshpddzd
打=hshhs
大=hpd
垯=hshhpddzd
瘩=dhpdhhsspdhszh
呆=szhhspd
呔=szhhpdd
歹=hpzd
逮=zhhsdhpddzd
傣=pshhhpdsdhpd
代=pshzd
轪=hzshhpd
垈=pshzdhsh
岱=pshzdszs
绐=zzhzdszh
迨=zdszhdzd
骀=zzhzdszh
带=hsssdzszs
待=ppshshhsd
怠=zdszhdzdd
殆=hpzdzdszh
玳=hhshpshzd
贷=pshzdszpd
埭=hshzhhsdhpd
袋=pshzddhpzpd
叇=hhzdzhhsdhpddzd
戴=hshszhshhsshpdzpd
黛=pshzdszdphshhdddd
丹=pzdh
妉=zphdzpz
单=dpszhhhs
担=hshszhhh
眈=szhhhdzpz
耽=hsshhhdzpz
郸=dpszhhhszs
聃=hsshhhszshh
殚=hpzddpszhhhs
瘅=dhpdhdpszhhhs
箪=phdphddpszhhhs
儋=pspzhppddhhhszh
胆=pzhhszhhh
疸=dhpdhszhhh
掸=hshdpszhhhs
赕=szpddppddppd
亶=dhszszhhszhhh
旦=szhhh
但=psszhhh
诞=dzpshzzd
疍=zshpdszhhh
啖=szhdppddppd
弹=zhzdpszhhhs
惮=ddsdpszhhhs
淡=ddhdppddppd
萏=hsspzphszhh
蛋=zshpdszhshd
氮=phhzdppddppd
憺=ddspzhppddhhhszh
澹=ddhpzhppddhhhszh
当=sdpzhh
珰=hhshsdpzhh
裆=dzspdsdpzhh
铛=phhhzsdpzhh
筜=phdphdsdpzhh
挡=hshsdpzhh
党=sdpdzszhpz
谠=dzsdpdzszhpz
凼=szpdzs
宕=ddzhpszh
砀=hpszhzpp
垱=hshsdpzhh
荡=hssddhzpp
档=hspdsdpzhh
菪=hssddzhpszh
刀=zp
叨=szhzp
忉=ddszp
氘=phhzps
舠=ppzdhdzp
鱽=pzszhshhzp
捯=hshhzdhshss
导=zhzhsd
岛=pzdzszs
捣=hshpzdzszs
祷=dzsdhhhphsd
蹈=szhshshpddppshzhh
到=hzdhshss
倒=pshzdhshss
悼=ddsshszhhhs
焘=hhhphsddddd
盗=dhpzpdszssh
道=dphpszhhhdzd
稻=phspdpddppshzhh
纛=hhshzzdhdszhhhhspdpzzdspd
嘚=szhppsszhhhhsd
得=ppsszhhhhsd
锝=phhhzszhhhhsd
德=ppshsszsshhdzdd
地=hshzsz
的=pszhhpzd
扽=hshhzsz
灯=dppdhs
登=zdppdhszhdph
噔=szhzdppdhszhdph
璒=hhshzdppdhszhdph
蹬=szhshshzdppdhszhdph
等=phdphdhshhsd
戥=szhhphhshhzpd
邓=zdzs
凳=zdppdhszhdphpz
嶝=szszdppdhszhdph
瞪=szhhhzdppdhszhdph
磴=hpszhzdppdhszhdph
镫=phhhzzdppdhszhdph
氐=pzhzd
低=pspzhzd
啲=szhpszhhpzd
羝=dphhhppzhzd
堤=hshszhhhshpd
滴=ddhdhdpszhsszh
镝=phhhzdhdpszhsszh
鞮=hsshszhhsszhhhshpd
狄=pzpdppd
籴=pddphspd
迪=szhshdzd
敌=phsszhphpd
涤=ddhpzdhspd
荻=hsspzpdppd
笛=phdphdszhsh
觌=hszddhpdszpz
髢=hshhhzdpppzsz
嘀=szhdhdpszhsszh
嫡=zphdhdpszhsszh
翟=zdhzdhpsdhhhsh
蹢=szhshshdhdpszhsszh
诋=dzpzhzd
邸=pzhzdzs
底=dhppzhzd
抵=hshpzhzd
柢=hspdpzhzd
砥=hpszhpzhzd
骶=szzdzszhhpzhzd
弟=dpzhzsp
杕=hspdhpd
玓=hhshpzd
俤=psdpzhzsp
帝=dhdpdzszs
娣=zphdpzhzsp
递=dpzhzspdzd
第=phdphdzhzsp
菂=hsspszhhpzd
谛=dzdhdpdzszs
媂=zphdhdpdzszs
棣=hspdzhhsdhpd
睇=szhhhdpzhzsp
缔=zzhdhdpdzszs
蒂=hssdhdpdzszs
禘=dzsddhdpdzszs
碲=hpszhdhdpdzszs
踶=szhshshszhhhshpd
甸=pzszhsh
掂=hshdhpshszh
滇=ddhhsszhhhhpd
颠=hsszhhhhpdhpszpd
巅=szshsszhhhhpdhpszpd
癫=dhpdhhsszhhhhpdhpszpd
典=szhsshpd
点=shszhdddd
碘=hpszhszhsshpd
踮=szhshshdhpshszh
电=szhhz
佃=psszhsh
阽=zsshszh
坫=hshshszh
店=dhpshszh
垫=hshpzdhsh
扂=dzhpshszh
玷=hhshshszh
钿=phhhzszhsh
惦=ddsdhpshszh
淀=ddhddzhshpd
奠=dphszpzhhhpd
琔=hhshddzhshpd
殿=zhphsshpdpzzd
靛=hhshszhhddzhshpd
癜=dhpdhzhphsshpdpzzd
簟=phdphdhszsshszhhhs
刁=zh
叼=szhzh
汈=ddhzh
凋=dhpzhshszh
貂=pddpzppzpszh
碉=hpszhpzhshszh
雕=pzhshszhpsdhhhsh
鲷=pzszhshhpzhshszh
屌=zhpszhszs
吊=szhszs
钓=phhhzpzd
窎=ddzpdpzdzh
调=dzpzhshszh
掉=hshshszhhhs
铞=phhhzszhszs
铫=phhhzpdhzpd
爹=pdpdpzdpzd
跌=szhshshphhpd
嗲=szhpdpdpzdpzd
迭=phhpddzd
垤=hshhzdhsh
昳=szhhphhpd
绖=zzhhzdhsh
瓞=ppzddphhpd
谍=dzhsshzhspd
喋=szhhsshzhspd
堞=hshhsshzhspd
耋=hshppzhzdhsh
叠=zdzdzddzszhhh
牒=pshzhsshzhspd
碟=hpszhhsshzhspd
蝶=szhshdhsshzhspd
蹀=szhshshhsshzhspd
鲽=pzszhshhhsshzhspd
哋=szhhshzsz
丁=hs
仃=pshs
叮=szhhs
玎=hhshhs
疔=dhpdhhs
盯=szhhhhs
钉=phhhzhs
耵=hsshhhhs
酊=hszpzhhhs
顶=hshpszpd
鼎=szhhhzhpshsz
订=dzhs
定=ddzhshpd
啶=szhddzhshpd
萣=hssddzhshpd
铤=phhhzphshzd
腚=pzhhddzhshpd
碇=hpszhddzhshpd
锭=phhhzddzhshpd
丢=phshzd
铥=phhhzphshzd
东=hzspd
冬=pzddd
咚=szhpzddd
岽=szshzspd
氡=phhzpzddd
鸫=hzspdpzdzh
董=hssphszhhshh
懂=ddshssphszhhshh
动=hhzdzp
冻=dhhzspd
侗=psszhszh
垌=hshszhszh
峒=szsszhszh
恫=ddsszhszh
栋=hspdhzspd
洞=ddhszhszh
胨=pzhhhzspd
胴=pzhhszhszh
硐=hpszhszhszh
都=hshpszhhzs
兜=pszhhpzzhpz
蔸=hsspszhhpzzhpz
篼=phdphdpszhhpzzhpz
抖=hshddhs
陡=zshshshpd
唞=szhhshddhs
蚪=szhshdddhs
斗=ddhs
豆=hszhdph
逗=hszhdphdzd
痘=dhpdhhszhdph
窦=ddzpdhszddhpd
厾=zhshzd
阇=dszhshpszhh
嘟=szhhshpszhhzs
督=shhspdzdszhhh
毒=hhshzzdhd
独=pzpszhshd
读=dzhszddhpd
渎=ddhhszddhpd
椟=hspdhszddhpd
牍=pshzhszddhpd
犊=phshhszddhpd
碡=hpszhhhshzzdhd
黩=szdphshhddddhszddhpd
髑=szzdzszhhszsshpzszhshd
笃=phdphdzzh
堵=hshhshpszhh
赌=szpdhshpszhh
睹=szhhhhshpszhh
芏=hsshsh
妒=zphdzhp
杜=hspdhsh
肚=pzhhhsh
度=dhphsshzd
渡=ddhdhphsshzd
镀=phhhzdhphsshzd
蠹=hszhsdzhpszhszhshdszhshd
耑=szshpszss
端=dhdphszshpszss
短=phhpdhszhdph
段=pshhhpzzd
断=dphspdzpphs
塅=hshpshhhpzzd
缎=zzhpshhhpzzd
椴=hspdpshhhpzzd
煅=dppdpshhhpzzd
瑖=hhshpshhhpzzd
锻=phhhzpshhhpzzd
簖=phdphddphspdzpphs
堆=hshpsdhhhsh
队=zspd
对=zdhsd
兑=dpszhpz
祋=dzsdpzzd
怼=zdhsddzdd
碓=hpszhpsdhhhsh
镦=phhhzdhszhzshphpd
吨=szhhzsz
惇=ddsdhszhzsh
敦=dhszhzshphpd
墩=hshdhszhzshphpd
礅=hpszhdhszhzshphpd
蹲=szhshshdphszpzhhhsd
蹾=szhshshdhszhzshphpd
盹=szhhhhzsz
趸=hzpszhshpd
囤=szhzszh
沌=ddhhzsz
炖=dppdhzsz
盾=pphsszhhh
砘=hpszhhzsz
钝=phhhzhzsz
顿=hzszhpszpd
遁=pphsszhhhdzd
楯=hspdpphsszhhh
多=pzdpzd
咄=szhzsszs
哆=szhpzdpzd
剟=zdzdzdzdss
掇=hshzdzdzdzd
裰=dzspdzdzdzdzd
夺=hpdhsd
铎=phhhzzdhhs
喥=szhdhphsshzd
踱=szhshshdhphsshzd
朵=pzhspd
哚=szhpzhspd
垛=hshpzhspd
埵=hshphshsshh
躲=pszhhhppzhspd
亸=dhszhzshdpszhhhs
剁=pzhspdss
饳=pzzzsszs
柁=hspdddzpz
堕=zshpszhhhsh
舵=ppzdhdddzpz
惰=ddshphshszhh
跺=szhshshpzhspd
婀=zphzshszhs
屙=zhpzshszhs
讹=dzpspz
俄=psphshzpd
娥=zphphshzpd
峨=szsphshzpd
涐=ddhphzhzpd
莪=hssphshzpd
锇=phhhzphshzpd
鹅=phshzpdpzdzh
蛾=szhshdphshzpd
额=ddzpzdszhhpszpd
厄=hpzz
呃=szhhpzz
扼=hshhpzz
苊=hsshpzz
轭=hzshhpzz
垩=hssdphhsh
姶=zphpdhszh
恶=hssdphdzdd
饿=pzzphshzpd
谔=dzszhszhhhz
鄂=szhszhhhzzs
阏=dszdhzppddd
崿=szsszhszhhhz
愕=ddsszhszhhhz
萼=hssszhszhhhz
遏=szhhpzpdzdzd
腭=pzhhszhszhhhz
锷=phhhzszhszhhhz
鹗=szhszhhhzpzdzh
颚=szhszhhhzhpszpd
噩=hsszhszhhszhszhh
鳄=pzszhshhszhszhhhz
诶=dzzdphhpd
奀=hpsdhpd
恩=szhpdhdzdd
蒽=hssszhpdhdzdd
摁=hshszhpdhdzdd
儿=pz
而=hpszss
陑=zshpszss
鸸=hpszsspzdzh
鲕=pzszhshhhpszss
尔=pzspd
耳=hsshhh
迩=pzspddzd
洱=ddhhsshhh
饵=pzzhsshhh
珥=hhshhsshhh
铒=phhhzhsshhh
二=hh
佴=pshsshhh
咡=szhhsshhh
贰=hhhszpdzd
发=zpzdd
乏=pdzd
伐=pshzpd
垡=pshzpdhsh
罚=szsshdzss
阀=dszpshzpd
砝=hpszhhshzd
筏=phdphdpshzpd
法=ddhhshzd
珐=hhshhshzd
帆=szspzd
番=pdphspdszhsh
噃=szhpdphspdszhsh
幡=szspdphspdszhsh
蕃=hsspdphspdszhsh
翻=pdphspdszhshzdhzdh
藩=hssddhpdphspdszhsh
凡=pzd
氾=ddhzz
矾=hpszhpzd
钒=phhhzpzd
烦=dppdhpszpd
墦=hshpdphspdszhsh
樊=hspdpdpdhspdhpd
燔=dppdpdphspdszhsh
璠=hhshpdphspdszhsh
繁=phzzdhdphpdzzdspd
蹯=szhshshpdphspdszhsh
蘩=hssphzzdhdphpdzzdspd
反=ppzd
返=ppzddzd
犯=pzpzz
泛=ddhpdzd
饭=pzzppzd
范=hssddhzz
贩=szpdppzd
畈=szhshppzd
梵=hspdhspdpzd
方=dhzp
邡=dhzpzs
坊=hshdhzp
芳=hssdhzp
枋=hspddhzp
牥=phshdhzp
钫=phhhzdhzp
蚄=szhshddhzp
防=zsdhzp
妨=zphdhzp
房=dzhpdhzp
肪=pzhhdhzp
鲂=pzszhshhdhzp
仿=psdhzp
访=dzdhzp
彷=ppsdhzp
纺=zzhdhzp
昉=szhhdhzp
舫=ppzdhddhzp
放=dhzpphpd
飞=zpd
妃=zphzhz
非=shhhshhh
啡=szhshhhshhh
绯=zzhshhhshhh
菲=hssshhhshhh
扉=dzhpshhhshhh
蜚=shhhshhhszhshd
霏=hdzsddddshhhshhh
鲱=pzszhshhshhhshhh
肥=pzhhzshz
淝=ddhpzhhzshz
腓=pzhhshhhshhh
朏=pzhhzsszs
匪=hshhhshhhz
诽=dzshhhshhh
悱=ddsshhhshhh
斐=shhhshhhdhpd
棐=shhhshhhhspd
榧=hspdhshhhshhhz
翡=shhhshhhzdhzdh
篚=phdphdhshhhshhhz
吠=szhhpdd
芾=hsshszs
废=dhpzpzdd
沸=ddhzhzps
狒=pzpzhzps
肺=pzhhhszs
费=zhzpsszpd
剕=shhhshhhss
痱=dhpdhshhhshhh
镄=phhhzzhzpsszpd
分=pdzp
吩=szhpdzp
纷=zzhpdzp
芬=hsspdzp
氛=phhzpdzp
翂=zdhzdhpdzp
棻=hsspdzphspd
酚=hszpzhhpdzp
坟=hshdhpd
汾=ddhpdzp
棼=hspdhspdpdzp
焚=hspdhspddppd
豮=hpzpppdhshssszpd
鼢=pshzhhzddzddzpdzp
粉=dphspdpdzp
份=pspdzp
奋=hpdszhsh
忿=pdzpdzdd
偾=pshshssszpd
愤=ddshshssszpd
粪=dphspdhsshpd
鲼=pzszhshhhshssszpd
瀵=ddhdphspdszhshhsshpd
丰=hhhs
风=pzpd
凨=pzhhzd
凬=pzhszhh
沣=ddhhhhs
沨=ddhpzpd
枫=hspdpzpd
封=hshhshhsd
疯=dhpdhpzpd
砜=hpszhpzpd
峰=szspzdhhhs
烽=dppdpzdhhhs
崶=szshshhshhsd
葑=hsshshhshhsd
锋=phhhzpzdhhhs
蜂=szhshdpzdhhhs
酆=shhhshhhszshszhdphzs
冯=dhzzh
浲=ddhpzdhhhs
逢=pzdhhhsdzd
讽=dzpzpd
唪=szhhhhpdhhs
凤=pzzd
奉=hhhpdhhs
俸=pshhhpdhhs
缝=zzhpzdhhhsdzd
赗=szpdszhhszhhh
缶=phhszs
否=hpsdszh
夫=hhpd
呋=szhhhpd
玞=hhshhhpd
肤=pzhhhhpd
砆=hpszhhhpd
垺=hshpddpzsh
趺=szhshshhhpd
麸=hhshpzdhhpd
稃=phspdpddpzsh
跗=szhshshpshsd
鄜=dhpzsshhzpzzs
孵=pzdpzsdpddpzsh
敷=hszhhsddhzpphpd
弗=zhzps
伏=pshpdd
凫=pzdzpz
佛=pszhzps
孚=pddpzsh
扶=hshhhpd
芙=hsshhpd
芣=hsshpsd
怫=ddszhzps
拂=hshzhzps
服=pzhhzszd
绂=zzhhpzdd
绋=zzhzhzps
苻=hsspshsd
茀=hsszhzps
俘=pspddpzsh
氟=phhzzhzps
洑=ddhpshpdd
祓=dzsdhpzdd
罘=szsshhpsd
茯=hsspshpdd
郛=pddpzshzs
韨=hhzshpzdd
浮=ddhpddpzsh
莩=hsspddpzsh
蚨=szhshdhhpd
匐=pzhszhszhsh
桴=hspdpddpzsh
涪=ddhdhdphszh
琈=hhshpddpzsh
符=phdphdpshsd
艴=zhzpspzzshz
菔=hsspzhhzszd
袱=dzspdpshpdd
幅=szshszhszhsh
福=dzsdhszhszhsh
蜉=szhshdpddpzsh
辐=hzshhszhszhsh
榑=hspdhszhhsdhsd
幞=szsssdphdphhhpd
蝠=szhshdhszhszhsh
黻=ssdphdpszspdhpzdd
呒=szhhhpz
抚=hshhhpz
甫=hszhhsd
府=dhppshsd
拊=hshpshsd
斧=pdpdpphs
俯=psdhppshsd
釜=pdpdhhsdph
辅=hzshhszhhsd
腑=pzhhdhppshsd
滏=ddhpdpdhhsdph
腐=dhppshsdszpdpd
簠=phdphdhszhhsdszssh
黼=ssdphdpszspdhszhhsd
父=pdpd
讣=dzsd
付=pshsd
妇=zphzhh
负=pzszpd
附=zspshsd
咐=szhpshsd
阜=pszhzhhs
驸=zzhpshsd
复=phszhhpzd
赴=hshshpdsd
副=hszhszhshss
傅=pshszhhsdhsd
富=ddzhszhszhsh
赋=szpdhhshshzd
缚=zzhhszhhsdhsd
腹=pzhhphszhhpzd
鲋=pzszhshhpshsd
赙=szpdhszhhsdhsd
蝮=szhshdphszhhpzd
覆=hszsshppsphszhhpzd
馥=phspdszhhphszhhpzd
旮=pzszhh
呷=szhszhhs
嘎=szhhpszhhhhzpd
钆=phhhzz
尜=spdhpdspd
噶=szhhssszhhpzpdz
尕=zpspd
尬=hpzpdps
该=dzdhzppd
陔=zsdhzppd
垓=hshdhzppd
荄=hssdhzppd
晐=szhhdhzppd
赅=szpddhzppd
改=zhzphpd
丐=hshz
钙=phhhzhshz
盖=dphhshszssh
溉=ddhzhhzdhzpz
戤=zpzdszsshhzpd
概=hspdzhhzdhzpz
甘=hsshh
杆=hspdhhs
玕=hhshhhs
肝=pzhhhhs
坩=hshhsshh
泔=ddhhsshh
矸=hpszhhhs
苷=hsshsshh
柑=hspdhsshh
竿=phdphdhhs
疳=dhpdhhsshh
酐=hszpzhhhhs
尴=hpzssphdszssh
扞=hshhhs
秆=phspdhhs
赶=hshshpdhhs
敢=zhsshhhphpd
感=hphszhzpddzdd
澉=ddhzhsshhhphpd
橄=hspdzhsshhhphpd
擀=hshhsszhhhspdhhs
鳡=pzszhshhhphszhzpddzdd
干=hhs
旰=szhhhhs
绀=zzhhsshh
淦=ddhpdhhsdph
骭=szzdzszhhhhs
赣=dhdphszhhhspzdhshszpd
冈=szpd
冮=dhhsh
刚=szpdss
杠=hspdhsh
纲=zzhszpd
肛=pzhhhsh
矼=hpszhhsh
缸=phhszshsh
钢=phhhzszpd
罡=szsshhshsh
堽=hshszsshhshsh
岗=szsszpd
港=ddhhsshpdzhz
筻=phdphdhszhhpd
戆=dhdphszhhhspzdhshszpddzdd
皋=pszhhhpdhs
羔=dphhshdddd
高=dhszhszszh
槔=hspdpszhhhpdhs
睾=pszsshhshdphhs
膏=dhszhdzszhszhh
篙=phdphddhszhszszh
糕=dphspddphhshdddd
杲=szhhhspd
搞=hshdhszhszszh
缟=zzhdhszhszszh
槁=hspddhszhszszh
稿=phspddhszhszszh
镐=phhhzdhszhszszh
藁=hssdhszhszszhhspd
告=phshszh
诰=dzphshszh
郜=phshszhzs
锆=phhhzphshszh
筶=phdphdphshszh
戈=hzpd
仡=psphz
圪=hshphz
纥=zzhphz
疙=dhpdhphz
咯=szhpzdszh
哥=hszhshszhs
胳=pzhhpzdszh
袼=dzspdpzdszh
鸽=pdhszhpzdzh
割=ddzhhhsszhss
搁=hshdszpzdszh
歌=hszhshszhspzpd
阁=dszpzdszh
革=hsshszhhs
格=hspdpzdszh
鬲=hszhszdphs
葛=hssszhhpzpdz
隔=zshszhszdphs
嗝=szhhszhszdphs
塥=hshhszhszdphs
滆=ddhhszhszdphs
膈=pzhhhszhszdphs
镉=phhhzhszhszdphs
骼=szzdzszhhpzdszh
哿=zpszhhszhs
舸=ppzdhdhszhs
个=pds
各=pzdszh
虼=szhshdphz
硌=hpszhpzdszh
铬=phhhzpzdszh
给=zzhpdhszh
根=hspdzhhzpd
跟=szhshshzhhzpd
哏=szhzhhzpd
艮=zhhzpd
亘=hszhhh
茛=hsszhhzpd
庚=dhpzhhpd
畊=szhshhhps
浭=ddhhszhhpd
耕=hhhspdhhps
赓=dhpzhhpdszpd
鹒=dhpzhhpdpzdzh
羹=dphhshdddddphhshhpd
哽=szhhszhhpd
埂=hshhszhhpd
绠=zzhhszhhpd
耿=hsshhhdppd
梗=hspdhszhhpd
鲠=pzszhshhhszhhpd
更=hszhhpd
暅=szhhddshszhhh
工=hsh
弓=zhz
公=pdzd
功=hshzp
攻=hshphpd
供=pshsshpd
肱=pzhhhpzd
宫=ddzszhszh
恭=hsshpdsddd
蚣=szhshdpdzd
躬=pszhhhpzhz
龚=hpzpdhsshpd
觥=pzpzhhssdphpz
巩=hshpzd
汞=hshszpd
拱=hshhsshpd
珙=hhshhsshpd
共=hsshpd
贡=hshszpd
唝=szhhshszpd
勾=pzzd
佝=pspzszh
沟=ddhpzzd
钩=phhhzpzzd
缑=zzhpszhphhpd
篝=phdphdhhsshszshh
鞲=hsshszhhshhsshszshh
芶=hsspzzd
岣=szspzszh
狗=pzppzszh
苟=hsspzszh
枸=hspdpzszh
玽=hhshpzszh
耇=hshppzszh
笱=phdphdpzszh
构=hspdpzzd
诟=dzpphszh
购=szpdpzzd
垢=hshpphszh
姤=zphpphszh
够=pzszhpzdpzd
媾=zphhhsshszshh
彀=hshdzhzhzpzzd
遘=hhsshszshhdzd
雊=pzszhpsdhhhsh
觏=hhsshszshhszpz
估=pshsszh
呱=szhppzdd
咕=szhhsszh
姑=zphhsszh
孤=zshppzdd
沽=ddhhsszh
轱=hzshhsszh
鸪=hsszhpzdzh
菇=hsszphhsszh
菰=hsszshppzdd
蛄=szhshdhsszh
觚=pzpzhhsppzdd
辜=hsszhdhdphhs
酤=hszpzhhhsszh
箍=phdphdhshhszsz
古=hsszh
汩=ddhszhh
诂=dzhsszh
谷=pdpdszh
股=pzhhpzzd
牯=phshhsszh
骨=szzdzszhh
罟=szsshhsszh
羖=dphhhppzzd
钴=phhhzhsszh
蛊=szhshdszssh
蓇=hssszzdzszhh
馉=pzzszzdzszhh
鹄=phshszhpzdzh
毂=hshdzhzshpzzd
鼓=hshszhdphhszd
嘏=hsszhzhshhzhzd
榖=hshdzhhspdpzzd
鹘=szzdzszhhpzdzh
臌=pzhhhshszhdphhszd
瀔=ddhhshdzhphspdpzzd
瞽=hshszhdphhszdszhhh
固=szhsszhh
故=hsszhphpd
顾=hpzzhpszpd
堌=hshszhsszhh
崮=szsszhsszhh
梏=hspdphshszh
牿=phshphshszh
雇=dzhppsdhhhsh
痼=dhpdhszhsszhh
锢=phhhzszhsszhh
鲴=pzszhshhszhsszhh
瓜=ppzdd
刮=phsszhss
胍=pzhhppzdd
栝=hspdphsszh
鸹=phsszhpzdzh
聒=hsshhhphsszh
剐=szhszpdss
寡=ddzhpszhhhpdzp
卦=hshhshsd
坬=hshppzdd
诖=dzhshhsh
挂=hshhshhsh
啩=szhhshhshsd
褂=dzspdhshhshsd
乖=phsshhpz
掴=hshszhhshdh
拐=hshszhzp
夬=zhpd
怪=ddszdhsh
关=dphhpd
观=zdszpz
官=ddzszhzh
冠=dzhhpzhsd
倌=psddzszhzh
棺=hspdddzszhzh
蒄=hssdzhhpzhsd
鳏=pzszhshhszsshsppdd
莞=hssddzhhpz
馆=pzzddzszhzh
琯=hhshddzszhzh
筦=phdphdddzhhpz
管=phdphdddzszhzh
鳤=pzszhshhphdphdddzszhzh
毌=zzsh
贯=zzshszpd
惯=ddszzshszpd
掼=hshzzshszpd
涫=ddhddzszhzh
祼=dzsdszhhhspd
盥=pshhszpdzhhszssh
灌=ddhhssszhszhpsdhhhsh
爟=dppdhssszhszhpsdhhhsh
瓘=hhshhssszhszhpsdhhhsh
鹳=hssszhszhpsdhhhshpzdzh
罐=phhszshssszhszhpsdhhhsh
光=sdphpz
咣=szhsdphpz
垙=hshsdphpz
洸=ddhsdphpz
桄=hspdsdphpz
珖=hhshsdphpz
胱=pzhhsdphpz
广=dhp
広=dhpzd
犷=pzpdhp
逛=pzphhshdzd
归=spzhh
圭=hshhsh
妫=zphdpzd
龟=pzszhhz
规=hhpdszpz
邽=hshhshzs
皈=pszhhppzd
闺=dszhshhsh
珪=hhshhshhsh
傀=pspszhhpzzd
硅=hpszhhshhsh
廆=dhppszhhpzzd
瑰=hhshpszhhpzzd
鲑=pzszhshhhshhsh
鬶=hhpdszpzhszhszdphs
宄=ddzpz
氿=ddhpz
轨=hzshpz
庋=dhphszd
匦=hhzshpzz
诡=dzpzhpzz
姽=zphpzhpzz
癸=zdppdhhpd
鬼=pszhhpzzd
晷=szhhpzdsdszh
簋=phdphdzhhzpdszssh
攰=hszdzp
刽=pdhhzdss
刿=szspzdss
柜=hspdhzhz
炔=dppdzhpd
贵=szhshszpd
桂=hspdhshhsh
桧=hspdpdhhzd
筀=phdphdhshhsh
跪=szhshshpzhpzz
鳜=pzszhshhhpdphzsppzpd
衮=dhpdzdpzpd
绲=zzhszhhhzpz
辊=hzshszhhhzpz
滚=ddhdhpdzdpzpd
磙=hpszhdhpdzdpzpd
鲧=pzszhshhpzzdspd
棍=hspdszhhhzpz
呙=szhszpd
埚=hshszhszpd
郭=dhszhzshzs
崞=szsdhszhzsh
锅=phhhzszhszpd
蝈=szhshdszhhshdh
国=szhhshdh
帼=szsszhhshdh
腘=pzhhszhhshdh
虢=pddphsdshzphzpz
馘=dphpszhhhhszhhzpd
果=szhhhspd
菓=hssszhhhspd
馃=pzzszhhhspd
椁=hspddhszhzsh
粿=dphspdszhhhspd
蜾=szhshdszhhhspd
裹=dhszhhhspdpzpd
过=hsddzd
哈=szhpdhszh
铪=phhhzpdhszh
蛤=szhshdpdhszh
咍=szhzdszh
咳=szhdhzppd
嗨=szhddhphzzdhd
还=hpsddzd
孩=zshdhzppd
骸=szzdzszhhdhzppd
海=ddhphzzdhd
胲=pzhhdhzppd
醢=hszpzhhhpszhszssh
亥=dhzppd
骇=zzhdhzppd
害=ddzhhhsszh
氦=phhzdhzppd
嗐=szhddzhhhsszh
嚡=szhhsshszhhshshhsh
顸=hhshpszpd
蚶=szhshdhsshh
酣=hszpzhhhsshh
憨=zhsshhhphpddzdd
鼾=pszhhhszhshhpshhs
邗=hhszs
含=pddzszh
邯=hsshhzs
函=zsdhpdzs
咁=szhhsshh
虷=szhshdhhs
浛=ddhpddzszh
崡=szszsdhpdzs
晗=szhhpddzszh
涵=ddhzsdhpdzs
焓=dppdpddzszh
琀=hhshpddzszh
寒=ddzhhsshpddd
嵅=szshphszhzpd
韩=hsszhhhshhzs
罕=dzpdhhs
喊=szhhphszhzpd
蔊=hssdppdszhhhhs
阚=dszzhsshhhphpd
汉=ddhzd
汗=ddhhhs
旱=szhhhhs
垾=hshszhhhhs
悍=ddsszhhhhs
捍=hshszhhhhs
焊=dppdszhhhhs
菡=hsszsdhpdzs
颔=pddzszhhpszpd
撖=hshzhsshhhphpd
暵=szhhhsshszhhhpd
憾=ddshphszhzpddzdd
撼=hshhphszhzpddzdd
翰=hsszhhhspdzdhzdh
瀚=ddhhsszhhhspdzdhzdh
夯=hpdzp
杭=hspddhpz
绗=zzhppshhs
珩=hhshppshhs
航=ppzdhddhpz
颃=dhpzhpszpd
沆=ddhdhpz
蒿=hssdhszhszszh
嚆=szhhssdhszhszszh
薅=hsszphhphhzpdhsd
蚝=szhshdphhz
毫=dhszhdzphhz
嗥=szhpszhhhpdhs
貉=pddpzpppzdszh
豪=dhszhdzhpzpppd
嚎=szhdhszhdzhpzpppd
壕=hshdhszhdzhpzpppd
濠=ddhdhszhdzhpzpppd
好=zphzsh
郝=hshpspdzs
号=szhhz
昊=szhhhhpd
恏=zphzshdzdd
浩=ddhphshszh
耗=hhhspdphhz
淏=ddhszhhhhpd
皓=pszhhphshszh
鄗=dhszhszszhzs
皞=pszhhpszhhhpdhs
颢=szhhdhszhspdhpszpd
灏=ddhszhhdhszhspdhpszpd
诃=dzhszhs
呵=szhhszhs
喝=szhszhhpzpdz
嗬=szhhsspshszhs
禾=phspd
合=pdhszh
何=pshszhs
劾=dhzppdzp
和=phspdszh
姀=zphphspd
河=ddhhszhs
郃=pdhszhzs
曷=szhhpzpdz
阂=dszdhzppd
饸=pzzpdhszh
核=hspddhzppd
盉=phspdszssh
盍=hshzdszssh
荷=hsspshszhs
涸=ddhszhsszhh
盒=pdhszhszssh
菏=hssddhhszhs
龁=shshpdzsphz
颌=pdhszhhpszpd
阖=dszhshzdszssh
鹖=szhhpzpdzpzdzh
翮=hszhszdphszdhzdh
鞨=hsshszhhsszhhpzpdz
龢=pdhszhszhszhszhssphspd
垎=hshpzdszh
贺=zpszhszpd
熇=dppddhszhszszh
褐=dzspdszhhpzpdz
赫=hshpspdhshpspd
鹤=dzpsdhhhshpzdzh
翯=zdhzdhdhszhszszh
壑=shdzhpdpdszhzdhsh
黑=szdphshhdddd
嘿=szhszdphshhdddd
痕=dhpdhzhhzpd
很=ppszhhzpd
狠=pzpzhhzpd
恨=ddszhhzpd
亨=dhszhzs
哼=szhdhszhzs
姮=zphhszhhh
恒=ddshszhhh
桁=hspdppshhs
鸻=ppshhspzdzh
横=hspdhsshszhshpd
衡=ppspzszhshhpdhhs
蘅=hssppspzszhshhpdhhs
堼=hshhshhsdhsh
吽=szhphhs
轰=hzhszdzd
哄=szhhsshpd
訇=pzdhhhszh
烘=dppdhsshpd
薨=hssszsshdzhpzdpz
弘=zhzzd
红=zzhhsh
宏=ddzhpzd
玒=hhshhsh
纮=zzhhpzd
闳=dszhpzd
泓=ddhzhzzd
洪=ddhhsshpd
竑=dhdphhpzd
荭=hsszzhhsh
虹=szhshdhsh
翃=hpzdzdhzdh
硔=hpszhhsshpd
鸿=ddhhshpzdzh
谼=pdpdszhhsshpd
蕻=hsshshhhzdhsshpd
黉=ddpdzhsshszhshpd
讧=dzhsh
齁=pszhhhszhshhpspzszh
侯=pszhphhpd
喉=szhpszhphhpd
猴=pzppszhphhpd
瘊=dhpdhpszhphhpd
篌=phdphdpszhphhpd
糇=dphspdpszhphhpd
骺=szzdzszhhpphszh
吼=szhzshz
犼=pzpzshz
后=pphszh
郈=pphszhzs
厚=hpszhhzsh
垕=pphszhhsh
逅=pphszhdzd
候=psszhphhpd
堠=hshpszhphhpd
鲎=ddpdzpzszhshh
鲘=pzszhshhpphszh
乎=pdphs
呼=szhpdphs
忽=pzppdzdd
昒=szhhpzpp
烀=dppdpdphs
轷=hzshpdphs
唿=szhpzppdzdd
惚=ddspzppdzdd
淴=ddhpzppdzdd
滹=ddhshzphzpdphs
囫=szpzpph
弧=zhzppzdd
狐=pzpppzdd
胡=hsszhpzhh
壶=hshdzssdph
隺=dzpsdhhhsh
斛=pzpzhhsddhs
湖=ddhhsszhpzhh
猢=pzphsszhpzhh
葫=hsshsszhpzhh
煳=dppdhsszhpzhh
瑚=hhshhsszhpzhh
鹕=hsszhpzhhpzdzh
槲=hspdpzpzhhsddhs
糊=dphspdhsszhpzhh
蝴=szhshdhsszhpzhh
縠=hshdzhzzdspdpzzd
醐=hszpzhhhsszhpzhh
觳=hshdzhpzpzhhspzzd
虎=shzphzpz
浒=ddhdzphhs
唬=szhshzphzpz
琥=hhshshzphzpz
互=hzzh
户=dzhp
冱=dhhzzh
护=hshdzhp
沪=ddhdzhp
岵=szshsszh
怙=ddshsszh
戽=dzhpddhs
昈=szhhdzhp
祜=dzsdhsszh
笏=phdphdpzpp
扈=dzhpszhzshz
瓠=hpdhhzppzdd
鄠=hdzsddddhhzzs
嫭=zphshzphzpdphs
嫮=zphhdzsddddhhz
鹱=pzdzhhsspsdhhhshzd
鳠=pzszhshhhsspsdhhhshzd
花=hsspspz
哗=szhpspzhs
华=pspzhs
骅=zzhpspzhs
铧=phhhzpspzhs
滑=ddhszzdzszhh
猾=pzpszzdzszhh
化=pspz
划=hzpdss
画=hszhshzs
话=dzphsszh
桦=hspdpspzhs
婳=zphhszhshzs
嬅=zphhsshhsshhs
觟=pzpzhhshshhsh
怀=ddshpsd
徊=ppsszszhh
淮=ddhpsdhhhsh
槐=hspdpszhhpzzd
踝=szhshshszhhhspd
坏=hshhpsd
欢=zdpzpd
獾=pzphssszhszhpsdhhhsh
环=hhshhpsd
郇=pzszhhzs
峘=szshszhhh
洹=ddhhszhhh
荁=hsshszhhh
桓=hspdhszhhh
萑=hsspsdhhhsh
貆=pddpzpphszhhh
锾=phhhzpddphhpzd
圜=szszsshhszhpzpdh
嬛=zphszsshhszhpzpd
寰=ddzszsshhszhpzpd
澴=ddhszsshhszhpzpd
缳=zzhszsshhszhpzpd
镮=phhhzszsshhszhpzpd
鹮=szsshhszhpzpdpzdzh
鬟=hshhhzdpppszsshhszhpzpd
缓=zzhpddphhpzd
幻=zzdz
奂=pzszhpd
宦=ddzhszhsz
唤=szhpzszhpd
换=hshpzszhpd
浣=ddhddzhhpz
涣=ddhpzszhpd
患=szhszhsdzdd
焕=dppdpzszhpd
逭=ddzszhzhdzd
痪=dhpdhpzszhpd
豢=dphhpdhpzpppd
漶=ddhszhszhsdzdd
鲩=pzszhshhddzhhpz
擐=hshszsshhszhpzpd
肓=dhzszhh
荒=hssdhzpsz
慌=ddshssdhzpsz
皇=pszhhhhsh
凰=pzpszhhhhsh
隍=zspszhhhhsh
黄=hsshszhshpd
喤=szhpszhhhhsh
媓=zphpszhhhhsh
徨=ppspszhhhhsh
惶=ddspszhhhhsh
湟=ddhpszhhhhsh
遑=pszhhhhshdzd
煌=dppdpszhhhhsh
瑝=hhshpszhhhhsh
潢=ddhhsshszhshpd
锽=phhhzpszhhhhsh
璜=hhshhsshszhshpd
篁=phdphdpszhhhhsh
艎=ppzdhdpszhhhhsh
蝗=szhshdpszhhhhsh
癀=dhpdhhsshszhshpd
磺=hpszhhsshszhshpd
簧=phdphdhsshszhshpd
蟥=szhshdhsshszhshpd
鳇=pzszhshhpszhhhhsh
恍=ddssdphpz
晃=szhhsdphpz
谎=dzhssdhzpsz
幌=szsszhhsdphpz
滉=ddhszhhsdphpz
灰=hpdppd
诙=dzhpdppd
咴=szhhpdppd
恢=ddshpdppd
挥=hshdzhzhs
虺=hpzszhshd
袆=dzspdhhzs
晖=szhhdzhzhs
珲=hhshdzhzhs
豗=hpzhpzpppd
翚=zdhzdhdzhzhs
辉=sdphpzdzhzhs
麾=dhphspdhspdphhz
徽=ppsszshzzdspdphpd
隳=zshphshszhhpdsddd
回=szszhh
洄=ddhszszhh
茴=hssszszhh
烠=dppdhpszhh
蛔=szhshdszszhh
悔=ddsphzzdhd
毁=pshzhhhshpzzd
卉=hshps
汇=ddhhz
会=pdhhzd
讳=dzhhzs
哕=szhszspzd
浍=ddhpdhhzd
绘=zzhpdhhzd
荟=hsspdhhzd
诲=dzphzzdhd
恚=hshhshdzdd
烩=dppdpdhhzd
贿=szpdhpszhh
彗=hhhshhhszhh
晦=szhhphzzdhd
秽=phspdszspzd
喙=szhzzhpzpppd
惠=hszhhshddzdd
翙=szspzdzdhzdh
慧=hhhshhhszhhdzdd
蕙=hsshszhhshddzdd
橞=hspdhszhhshddzdd
蟪=szhshdhszhhshddzdd
昏=pzhzszhh
荤=hssdzhzhs
婚=zphpzhzszhh
惛=ddspzhzszhh
阍=dszpzhzszhh
浑=ddhdzhzhs
馄=pzzszhhhzpz
魂=hhzdpszhhpzzd
诨=dzdzhzhs
混=ddhszhhhzpz
溷=ddhszhpzpppdh
耠=hhhspdpdhszh
锪=phhhzpzppdzdd
劐=hsspsdhhhshzdss
嚄=szhhsspsdhhhshzd
豁=ddzhhhsszhpdpdszh
攉=hshhdzsddddpsdhhhsh
佸=psphsszh
活=ddhphsszh
火=dppd
伙=psdppd
钬=phhhzdppd
漷=ddhdhszhzshzs
夥=szhhhspdpzdpzd
或=hszhhzpd
货=pspzszpd
砉=hhhshpszh
获=hsspzphpdd
祸=dzsdszhszpd
惑=hszhhzpddzdd
濩=ddhhsspsdhhhshzd
霍=hdzsddddpsdhhhsh
镬=phhhzhsspsdhhhshzd
嚯=szhhdzsddddpsdhhhsh
藿=hsshdzsddddpsdhhhsh
蠖=szhshdhsspsdhhhshzd
讥=dzpz
击=hhszs
叽=szhpz
饥=pzzpz
乩=shszhz
圾=hshpzd
机=hspdpz
玑=hhshpz
肌=pzhhpz
芨=hsspzd
矶=hpszhpz
鸡=zdpzdzh
枅=hspdhhps
迹=dhpspddzd
剞=hpdhszhsss
唧=szhzhhzdzs
姬=zphhsszhsz
屐=zhpppshszd
积=phspdszhpd
笄=phdphdhhps
基=hsshhhpdhsh
绩=zzhhhshszpd
嵇=phspdhpzdszs
犄=phshhpdhszhs
缉=zzhszhhsshhh
赍=hspdpddzszpd
畸=szhshhpdhszhs
跻=szhshshdhpdps
箕=phdphdhsshhhpd
畿=zzdzzdhszhshzpd
稽=phspdhpzdpzszhh
觭=pzpzhhshpdhszhs
齑=dhpdshhhshhhhps
墼=hszhhhszspzzdhsh
激=ddhpszhhdhzpphpd
羁=szsshhsshszhhszzh
及=pzd
伋=pspzd
吉=hshszh
岌=szspzd
汲=ddhpzd
级=zzhpzd
即=zhhzdzs
极=hspdpzd
亟=zsszhzdh
佶=pshshszh
诘=dzhshszh
姞=zphhshszh
急=pzzhhdzdd
笈=phdphdpzd
疾=dhpdhphhpd
脊=dhpdpdszhh
戢=szhhsshhhzpd
棘=hszspdhszspd
殛=hpzdzsszhzdh
集=psdhhhshhspd
嫉=zphdhpdhphhpd
楫=hspdszhhsshhh
蒺=hssdhpdhphhpd
辑=hzshszhhsshhh
耤=hhhspdhsshszhh
瘠=dhpdhdhpdpdszhh
蕺=hssszhhsshhhzpd
鹡=dhpdpdszhhpzdzh
藉=hsshhhspdhsshszhh
蹐=szhshshdhppddszhh
籍=phdphdhhhspdhsshszhh
几=pz
己=zhz
虮=szhshdpz
挤=hshdhpdps
掎=hshhpdhszhs
鱾=pzszhshhzhz
戟=hsszhhhshzpd
嵴=szsdhpdpdszhh
麂=dhpzsshhzpzpz
计=dzhs
记=dzzhz
伎=pshszd
纪=zzhzhz
妓=zphhszd
忌=zhzdzdd
技=hshhszd
芰=hsshszd
际=zshhspd
剂=dhpdpsss
季=phspdzsh
垍=hshpszhhh
既=zhhzdhzpz
洎=ddhpszhhh
济=ddhdhpdps
荠=hssdhpdps
继=zzhdphspdz
觊=szszhzszpz
偈=psszhhpzpdz
寂=ddzshhspdzd
寄=ddzhpdhszhs
徛=ppshpdhszhs
悸=ddsphspdzsh
祭=pzddzdhhspd
惎=hsshhhpddzdd
蓟=hsspzszhshhss
暨=zhhzdhzpzszhhh
漈=ddhpzddzdhhspd
跽=szhshshzhzdzdd
霁=hdzsdddddhpdps
鲚=pzszhshhdhpdps
稷=phspdszhshpdpzd
鲫=pzszhshhzhhzdzs
冀=shhpzszhshhsshpd
穄=phspdpzddzdhhspd
髻=hshhhzdppphshszh
罽=szsshhpdppddppdss
骥=zzhshhpzszhshhsshpd
瀱=ddhszsshhpdppddppdss
加=zpszh
夹=hdphpd
伽=pszpszh
佳=pshshhsh
泇=ddhzpszh
茄=hsszpszh
迦=zpszhdzd
枷=hspdzpszh
浃=ddhhdphpd
珈=hhshzpszh
家=ddzhpzpppd
痂=dhpdhzpszh
笳=phdphdzpszh
袈=zpszhdhpzpd
葭=hsszhshhzhzd
跏=szhshshzpszh
嘉=hshszhdphzpszh
镓=phhhzddzhpzpppd
郏=hdphpdzs
荚=hsshdphpd
恝=hhhszpdzdd
戛=hpszhhhhzpd
铗=phhhzhdphpd
蛱=szhshdhdphpd
颊=hdphpdhpszpd
甲=szhhs
岬=szsszhhs
胛=pzhhszhhs
贾=hszsshszpd
钾=phhhzszhhs
假=pszhshhzhzd
斝=szhszhdzddhs
槚=hspdhszsshszpd
瘕=dhpdhzhshhzhzd
价=pspdps
驾=zpszhzzh
架=zpszhhspd
嫁=zphddzhpzpppd
稼=phspdddzhpzpppd
戋=hhzpd
奸=zphhhs
尖=spdhpd
坚=sszdhsh
歼=hpzdphs
间=dszszhh
肩=dzhpszhh
艰=zdzhhzpd
兼=dphzhhsspd
监=ssphdszssh
笺=phdphdhhzpd
菅=hssddzszhzh
湔=ddhdphszhhss
犍=phshzhhhhszd
缄=zzhhphszhzpd
搛=hshdphzhhsspd
煎=dphszhhssdddd
瑊=hhshhphszhzpd
缣=zzhdphzhhsspd
蒹=hssdphzhhsspd
鲣=pzszhshhsszdhsh
鹣=dphzhhsspdpzdzh
篯=phdphdphhhzhhzpd
鞬=hsshszhhszhhhhszd
鞯=hsshszhhshsshpszsh
鳒=pzszhshhdphzhhsspd
囝=szzshh
拣=hshhzzpd
枧=hspdszpz
俭=pspdhddph
柬=hszdphspd
茧=hssszhshd
捡=hshpdhddph
笕=phdphdszpz
减=dhhphszhzpd
剪=dphszhhsszp
检=hspdpdhddph
趼=szhshshhhps
睑=szhhhpdhddph
裥=dzspddszszhh
锏=phhhzdszszhh
暕=szhhhszdphspd
简=phdphddszszhh
谫=dzdphszhhsszp
戬=hssdphszhhhzpd
碱=hpszhhphszhzpd
翦=dphszhhsszdhzdh
謇=ddzhhsshpddhhhszh
蹇=ddzhhsshpdszhshpd
见=szpz
件=psphhs
建=zhhhhszd
饯=pzzhhzpd
剑=pdhddphss
牮=pshzdphhs
荐=hsshpszsh
贱=szpdhhzpd
健=pszhhhhszd
涧=ddhdszszhh
舰=ppzdhdszpz
渐=ddhhzshpphs
谏=dzhszdphspd
楗=hspdzhhhhszd
毽=phhzzhhhhszd
溅=ddhszpdhhzpd
腱=pzhhzhhhhszd
践=szhshshhhzpd
鉴=ssphdpdhhsdph
键=phhhzzhhhhszd
僭=pshzpzhzpzszhh
箭=phdphddphszhhss
踺=szhshshzhhhhszd
江=ddhhsh
姜=dphhshzph
将=dhspzdhsd
茳=hssddhhsh
浆=dhspzdszpd
豇=hszhdphhsh
僵=pshszhshhszhshh
缰=zzhhszhshhszhshh
鳉=pzszhshhdhspzdhsd
礓=hpszhhszhshhszhshh
疆=zhzhshhszhshhszhshh
讲=dzhhps
奖=dhspzdhpd
桨=dhspzdhspd
蒋=hssdhspzdhsd
耩=hhhspdhhsshszshh
膙=pzhhzhzszhszhshd
匠=hpphsz
降=zspzdhzs
洚=ddhpzdhzs
绛=zzhpzdhzs
弶=zhzdhszhspd
酱=dhspzdhszpzhh
犟=zhzszhszhshdphhs
糨=dphspdzhzszhszhshd
艽=hsspz
交=dhpdpd
郊=dhpdpdzs
姣=zphdhpdpd
娇=zphphpdps
峧=szsdhpdpd
浇=ddhhzphpz
茭=hssdhpdpd
骄=zzhphpdps
胶=pzhhdhpdpd
椒=hspdshhspdzd
焦=psdhhhshdddd
蛟=szhshddhpdpd
跤=szhshshdhpdpd
僬=pspsdhhhshdddd
鲛=pzszhshhdhpdpd
蕉=hsspsdhhhshdddd
燋=dppdpsdhhhshdddd
礁=hpszhpsdhhhshdddd
鹪=psdhhhshddddpzdzh
角=pzpzhhs
佼=psdhpdpd
侥=pshzphpz
恔=ddsdhpdpd
狡=pzpdhpdpd
绞=zzhdhpdpd
饺=pzzdhpdpd
皎=pszhhdhpdpd
矫=phhpdphpdps
脚=pzhhhshzdzs
铰=phhhzdhpdpd
搅=hshddpdzszpz
湫=ddhphspddppd
剿=zzzhzhhhspdss
敫=pszhhdhzpphpd
徼=ppspszhhdhzpphpd
缴=zzhpszhhdhzpphpd
璬=hhshpszhhdhzpphpd
皦=pszhhpszhhdhzpphpd
叫=szhzs
峤=szsphpdps
轿=hzshphpdps
较=hzshdhpdpd
教=hshpzshphpd
窖=ddzpdphshszh
滘=ddhdzpdhshszh
斠=hhsshszshhddhs
漖=ddhhshpzshphpd
酵=hszpzhhhshpzsh
噍=szhpsdhhhshdddd
藠=hsspszhhpszhhpszhh
醮=hszpzhhpsdhhhshdddd
皭=pszhhpddpszsshzhhzdhsd
阶=zspdps
疖=dhpdhzs
皆=hzpzpszhh
接=hshdhdphzph
秸=phspdhshszh
喈=szhhzpzpszhh
嗟=szhdphhhphsh
揭=hshszhhpzpdz
湝=ddhhzpzpszhh
街=ppshshhshhhs
孑=zsh
节=hsszs
讦=dzhhs
劫=hshzdzp
岊=zshzszs
劼=hshszhzp
杰=hspddddd
拮=hshhshszh
洁=ddhhshszh
结=zzhhshszh
桀=pzdhzshspd
婕=zphhzhhshpd
捷=hshhzhhshpd
絜=hhhszpzzdspd
颉=hshszhhpszpd
睫=szhhhhzhhshpd
蜐=szhshdhshzdzp
截=hshpsdhhhshzpd
碣=hpszhszhhpzpdz
竭=dhdphszhhpzpdz
鲒=pzszhshhhshszh
羯=dphhhpszhhpzpdz
姐=zphszhhh
解=pzpzhhszpphhs
檞=hspdpzpzhhszpphhs
介=pdps
戒=hhpszpd
芥=hsspdps
届=zhpszhsh
玠=hhshpdps
界=szhshpdps
疥=dhpdhpdps
诫=dzhhpszpd
借=pshsshszhh
悈=ddshhpszpd
蚧=szhshdpdps
骱=szzdzszhhpdps
褯=dzspddhphsshszs
巾=szs
今=pddz
斤=pphs
金=pdhhsdph
津=ddhzhhhhs
矜=zdzsppddz
衿=dzspdpddz
珒=hhshzhhhhs
筋=phdphdpzhhzp
襟=dzspdhspdhspdhhspd
仅=pszd
尽=zhpddd
卺=zszpdhzz
紧=sszdzzdspd
堇=hsshszhhhsh
谨=dzhsshszhhhsh
锦=phhhzpszhhszs
廑=dhphsshszhhhsh
馑=pzzhsshszhhhsh
槿=hspdhsshszhhhsh
瑾=hhshhsshszhhhsh
劲=zdhshzp
妗=zphpddz
近=pphsdzd
进=hhpsdzd
浕=ddhzhpddd
荩=hsszhpddd
晋=hssdphszhh
浸=ddhzhhdzzd
烬=dppdzhpddd
赆=szpdzhpddd
琎=hhshhhpsdzd
祲=dzsdzhhdzzd
溍=ddhhssdphszhh
禁=hspdhspdhhspd
缙=zzhhssdphszhh
靳=hsshszhhspphs
墐=hshhsshszhhhsh
瑨=hhshhssdphszhh
殣=hpzdhsshszhhhsh
觐=hsshszhhhshszpz
噤=szhhspdhspdhhspd
京=dhszhspd
泾=ddhzdhsh
经=zzhzdhsh
茎=hsszdhsh
荆=hsshhpsss
惊=ddsdhszhspd
旌=dhzpphphhsh
猄=pzpdhszhspd
菁=hsshhshszhh
晶=szhhszhhszhh
腈=pzhhhhshszhh
睛=szhhhhhshszhh
粳=dphspdhszhhpd
兢=hsszhpzhsszhpz
精=dphspdhhshszhh
鲸=pzszhshhdhszhspd
麖=dhpzsshhzpzdhszhspd
鼱=pshzhhzddzddzhhshszhh
井=hhps
丼=hhpsd
阱=zshhps
刭=zdhshss
汫=ddhhhps
肼=pzhhhhps
颈=zdhshhpszpd
景=szhhdhszhspd
儆=pshsspzszhphpd
憬=ddsszhhdhszhspd
璟=hhshszhhdhszhspd
璥=hhshhsspzszhphpd
警=hsspzszhphpddhhhszh
净=dhpzzhhs
径=ppszdhsh
迳=zdhshdzd
胫=pzhhzdhsh
倞=psdhszhspd
痉=dhpdhzdhsh
竞=dhdphszhpz
婧=zphhhshszhh
竫=dhdphpzzhhs
竟=dhdphszhhpz
敬=hsspzszhphpd
靓=hhshszhhszpz
靖=dhdphhhshszhh
境=hshdhdphszhhpz
獍=pzpdhdphszhhpz
静=hhshszhhpzzhhs
镜=phhhzdhdphszhhpz
坰=hshszhszh
扃=dzhpszszh
冏=szpdszh
囧=szpdszh
泂=ddhszszh
炅=szhhdppd
迥=szszhdzd
炯=dppdszszh
窘=ddzpdzhhpszh
颎=pzdppdhpszpd
纠=zzhzs
究=ddzpdpz
鸠=pzpzdzh
赳=hshshpdzs
阄=dszpzszhhz
啾=szhphspddppd
揪=hshphspddppd
鬏=hshhhzdpppphspddppd
九=pz
久=pzd
灸=pzddppd
玖=hhshpzd
韭=shhhshhhh
酒=ddhhszpzhh
旧=sszhh
臼=pshzhh
咎=pzdsdszh
疚=dhpdhpzd
柩=hspdhpzdz
桕=hspdpshzhh
厩=hpzhhzdhzpz
救=hsdhpddphpd
就=dhszhspdhpzd
舅=pshzhhszhshzp
僦=psdhszhspdhpzd
鹫=dhszhspdhpzdpzdzh
居=zhphsszh
拘=hshpzszh
泃=ddhpzszh
狙=pzpszhhh
苴=hssszhhh
驹=zzhpzszh
疽=dhpdhszhhh
砠=hpszhszhhh
娵=zphhsshhhzd
崌=szszhphsszh
掬=hshpzdphspd
菹=hssddhszhhh
椐=hspdzhphsszh
琚=hhshzhphsszh
腒=pzhhzhphsszh
趄=hshshpdszhhh
锔=phhhzzhpzszh
裾=dzspdzhphsszh
雎=szhhhpsdhhhsh
鞠=hsshszhhspzdphspd
鞫=hsshszhhspzdhhhszh
局=zhpzszh
桔=hspdhshszh
焗=dppdzhpzszh
菊=hsspzdphspd
橘=hspdzdzspszpdszh
咀=szhszhhh
弆=hshzdhps
沮=ddhszhhh
举=ddphpdhhs
矩=phhpdhzhz
莒=hssszhszh
筥=phdphdszhszh
榉=hspdddphpdhhs
蒟=hssdhdphpzszh
龃=shshpdzsszhhh
踽=szhshshpszhszshd
巨=hzhz
句=pzszh
讵=dzhzhz
岠=szshzhz
拒=hshhzhz
苣=hsshzhz
具=szhhhhpd
炬=dppdhzhz
秬=phspdhzhz
钜=phhhzhzhz
俱=psszhhhhpd
倨=pszhphsszh
剧=zhphsszhss
惧=ddsszhhhhpd
据=hshzhphsszh
距=szhshshhzhz
犋=phshszhhhhpd
飓=pzpdszhhhhpd
锯=phhhzzhphsszh
窭=ddzpddphspdzph
聚=hsshhhzdpspppd
屦=zhpppsdphspdzph
踞=szhshshzhphsszh
澽=ddhshzphzhpzpppd
遽=shzphzhpzpppddzd
醵=hszpzhhshzphzhpzpppd
娟=zphszhszhh
捐=hshszhszhh
涓=ddhszhszhh
焆=dppdszhszhh
鹃=szhszhhpzdzh
镌=phhhzpsdhhhshzp
蠲=dphpdszsshszsshpzszhshd
卷=dphhpdzz
锩=phhhzdphhpdzz
倦=psdphhpdzz
桊=dphhpdhspd
狷=pzpszhszhh
绢=zzhszhszhh
隽=psdhhhshzp
眷=dphhpdszhhh
鄄=hszsshhshzs
罥=szsshszhszhh
噘=szhhpdphzsppzpd
撅=hshhpdphzsppzpd
孓=zsd
决=dhzhpd
诀=dzzhpd
抉=hshzhpd
玦=hhshzhpd
珏=hhshhhshd
砄=hpszhzhpd
绝=zzhpzzshz
觉=ddpdzszpz
倔=pszhpzsszs
崛=szszhpzsszs
掘=hshzhpzsszs
桷=hspdpzpzhhs
觖=pzpzhhszhpd
傕=psdzpsdhhhsh
厥=hpdphzsppzpd
劂=hpdphzsppzpdss
谲=dzzdzspszpdszh
獗=pzphpdphzsppzpd
蕨=hsshpdphzsppzpd
噱=szhshzphzhpzpppd
橛=hspdhpdphzsppzpd
爵=pddpszsshzhhzdhsd
镢=phhhzhpdphzsppzpd
蹶=szhshshhpdphzsppzpd
嚼=szhpddpszsshzhhzdhsd
矍=szhhhszhhhpsdhhhshzd
爝=dppdpddpszsshzhhzdhsd
攫=hshszhhhszhhhpsdhhhshzd
玃=pzpszhhhszhhhpsdhhhshzd
军=dzhzhs
君=zhhpszh
均=hshpzdh
钧=phhhzpzdh
莙=hsszhhpszh
皲=dzhzshzpszd
菌=hssszphspdh
鲪=pzszhshhzhhpszh
麇=dhpzsshhzpzphspd
俊=pszdpdpzd
郡=zhhpszhzs
峻=szszdpdpzd
捃=hshzhhpszh
浚=ddhzdpdpzd
骏=zzhzdpdpzd
晙=szhhzdpdpzd
焌=dppdzdpdpzd
珺=hhshzhhpszh
畯=szhshzdpdpzd
竣=dhdphzdpdpzd
咔=szhshhsd
咖=szhzpszh
喀=szhddzpzdszh
卡=shhsd
佧=psshhsd
胩=pzhhshhsd
开=hhps
揩=hshhzpzpszhh
锎=phhhzdszhhps
凯=szszhzpz
剀=szszhzss
垲=hshszszhz
恺=ddsszszhz
闿=dszszszhz
铠=phhhzszszhz
嘅=szhzhhzdhzpz
慨=ddszhhzdhzpz
蒈=hsshzpzpszhh
楷=hspdhzpzpszhh
锴=phhhzhzpzpszhh
忾=ddsphhz
炌=dppdpdps
刊=hhsss
勘=hsshhhpdzzp
龛=pdhszhhpzpd
堪=hshhsshhhpdz
嵁=szshsshhhpdz
戡=hsshhhpdzhzpd
冚=dzszs
坎=hshpzpd
侃=psszhpsz
砍=hpszhpzpd
莰=hsshshpzpd
槛=hspdssphdszssh
看=phhpszhhh
衎=ppshhshhs
崁=szshshpzpd
墈=hshhsshhhpdzzp
瞰=szhhhzhsshhhphpd
磡=hpszhhsshhhpdzzp
闶=dszdhpz
康=dhpzhhsdhpd
慷=ddsdhpzhhsdhpd
糠=dphspddhpzhhsdhpd
扛=hshhsh
亢=dhpz
伉=psdhpz
抗=hshdhpz
炕=dppddhpz
钪=phhhzdhpz
尻=zhppz
考=hshphz
拷=hshhshphz
洘=ddhhshphz
栲=hspdhshphz
烤=dppdhshphz
铐=phhhzhshphz
犒=phshdhszhszszh
靠=phshszhshhhshhh
匼=hpdhszhz
苛=hsshszhs
柯=hspdhszhs
牁=zshphszhs
珂=hhshhszhs
科=phspdddhs
轲=hzshhszhs
疴=dhpdhhszhs
棵=hspdszhhhspd
颏=dhzppdhpszpd
嗑=szhhshzdszssh
稞=phspdszhhhspd
窠=ddzpdszhhhspd
颗=szhhhspdhpszpd
瞌=szhhhhshzdszssh
磕=hpszhhshzdszssh
蝌=szhshdphspdddhs
髁=szzdzszhhszhhhspd
壳=hshdzpz
可=hszhs
坷=hshhszhs
岢=szshszhs
炣=dppdhszhs
渴=ddhszhhpzpdz
克=hsszhpz
刻=dhzppdss
客=ddzpzdszh
恪=ddspzdszh
课=dzszhhhspd
氪=phhzhsszhpz
骒=zzhszhhhspd
缂=zzhhsshszhhs
溘=ddhhshzdszssh
锞=phhhzszhhhspd
剋=hsszhpzss
肯=shshszhh
垦=zhhzpdhsh
恳=zhhzpddzdd
啃=szhshshszhh
龈=shshpdzszhhzpd
裉=dzspdzhhzpd
吭=szhdhpz
坑=hshdhpz
硁=hpszhzdhsh
铿=phhhzsszdhsh
空=ddzpdhsh
倥=psddzpdhsh
埪=hshddzpdhsh
崆=szsddzpdhsh
硿=hpszhddzpdhsh
箜=phdphdddzpdhsh
孔=zshz
恐=hshpzddzdd
控=hshddzpdhsh
抠=hshhpdz
芤=hsszshz
眍=szhhhhpdz
口=szh
叩=szhzs
扣=hshszh
寇=ddzhhpzshzd
筘=phdphdhshszh
蔻=hssddzhhpzshzd
刳=hpdhhzss
矻=hpszhphz
枯=hspdhsszh
哭=szhszhhpdd
堀=hshzhpzsszs
圐=szszsshdhzph
窟=ddzpdzhpzsszs
骷=szzdzszhhhsszh
苦=hsshsszh
库=dhphzhs
绔=zzhhpdhhz
喾=ddpdzphshszh
裤=dzspddhphzhs
酷=hszpzhhphshszh
夸=hpdhhz
姱=zphhpdhhz
侉=pshpdhhz
垮=hshhpdhhz
挎=hshhpdhhz
胯=pzhhhpdhhz
跨=szhshshhpdhhz
蒯=hsspzhhpzhhss
块=hshzhpd
快=ddszhpd
侩=pspdhhzd
郐=pdhhzdzs
哙=szhpdhhzd
狯=pzppdhhzd
脍=pzhhpdhhzd
筷=phdphdddszhpd
鲙=pzszhshhpdhhzd
宽=ddzhssszpz
髋=szzdzszhhddzhssszpz
款=hshhhspdpzpd
匡=hhhshz
诓=dzhhhshz
哐=szhhhhshz
洭=ddhhhhshz
框=hspdhhhshz
筐=phdphdhhhshz
狂=pzphhsh
诳=dzpzphhsh
夼=hpdpss
邝=dhpzs
圹=hshdhp
纩=zzhdhp
况=dhszhpz
旷=szhhdhp
矿=hpszhdhp
贶=szpdszhpz
眶=szhhhhhhshz
亏=hhz
岿=szsspzhh
悝=ddsszhhshh
盔=hpdppdszssh
窥=ddzpdhhpdszpz
奎=hpdhshhsh
逵=hshpdhshdzd
隗=zspszhhpzzd
馗=pzdphpszhhh
喹=szhhpdhshhsh
揆=hshzdppdhhpd
葵=hsszdppdhhpd
骙=zzhzdppdhhpd
戣=zdppdhhpdhzpd
暌=szhhzdppdhhpd
魁=pszhhpzzdddhs
睽=szhhhzdppdhhpd
蝰=szhshdhpdhshhsh
櫆=hspdpszhhpzzdddhs
夔=dphpszhhhshshzhzpdpzd
煃=dppdhpdhshhsh
跬=szhshshhshhsh
匮=hszhshszpdz
喟=szhszhshszhh
愦=ddsszhshszpd
愧=ddspszhhpzzd
溃=ddhszhshszpd
蒉=hssszhshszpd
馈=pzzszhshszpd
篑=phdphdszhshszpd
聩=hsshhhszhshszpd
坤=hshszhhs
昆=szhhhzpz
堃=dhzpdhzphsh
婫=zphszhhhzpz
崑=szsszhhhzpz
裈=dzspddzhzhs
焜=dppdszhhhzpz
琨=hhshszhhhzpz
锟=phhhzszhhhzpz
髡=hshhhzdppphpz
鹍=szhhhzpzpzdzh
醌=hszpzhhszhhhzpz
鲲=pzszhshhszhhhzpz
悃=ddsszhspdh
捆=hshszhspdh
阃=dszszhspdh
壸=hshdzhssdph
困=szhspdh
扩=hshdhp
括=hshphsszh
蛞=szhshdphsszh
阔=dszddhphsszh
廓=dhpdhszhzshzs
垃=hshdhdph
拉=hshdhdph
菈=hsshshdhdph
邋=zzzszpdhzddzddzdzd
旯=szhhpz
剌=hszhspdss
砬=hpszhdhdph
喇=szhhszhspdss
腊=pzhhhsshszhh
瘌=dhpdhhszhspdss
蜡=szhshdhsshszhh
辣=dhdphhphszhspd
蝲=szhshdhszhspdss
镴=phhhzzzzszpdhzddzddz
啦=szhhshdhdph
鞡=hsshszhhshshdhdph
来=hdphspd
俫=pshdphspd
崃=szshdphspd
徕=ppshdphspd
涞=ddhhdphspd
莱=hsshdphspd
梾=hspdhdphspd
铼=phhhzhdphspd
赉=hdphspdszpd
睐=szhhhhdphspd
赖=hszhspdpzszpd
濑=ddhhszhspdpzszpd
癞=dhpdhhszhspdpzszpd
籁=phdphdhszhspdpzszpd
兰=dphhh
岚=szspzpd
拦=hshdphhh
栏=hspddphhh
婪=hspdhspdzph
阑=dszhszdphspd
蓝=hssssphdszssh
谰=dzdszhszdphspd
澜=ddhdszhszdphspd
褴=dzspdssphdszssh
斓=dhpddszhszdphspd
篮=phdphdssphdszssh
襕=dzspddszhszdphspd
镧=phhhzdszhszpdhspd
躝=szhshshszhhszhhhszdphspd
览=ssphdszpz
揽=hshssphdszpz
缆=zzhssphdszpz
榄=hspdssphdszpz
漤=ddhhspdhspdzph
罱=szsshhsszdphhs
懒=ddshszhspdpzszpd
烂=dppddphhh
滥=ddhssphdszssh
啷=szhdzhhzdzs
郎=dzhhzdzs
狼=pzpdzhhzpd
阆=dszdzhhzpd
廊=dhpdzhhzdzs
桹=hspddzhhzpd
琅=hhshdzhhzpd
榔=hspddzhhzdzs
稂=phspddzhhzpd
锒=phhhzdzhhzpd
筤=phdphddzhhzpd
螂=szhshddzhhzdzs
朗=dzhhzdpzhh
烺=dppddzhhzpd
塱=dzhhzdpzhhhsh
蓢=hssdzhhzdpzhh
朤=pzhhpzhhpzhhpzhh
埌=hshdzhhzpd
崀=szsdzhhzpd
浪=ddhdzhhzpd
莨=hssdzhhzpd
蒗=hssddhdzhhzpd
捞=hshhssdzzp
劳=hssdzzp
牢=ddzphhs
唠=szhhssdzzp
崂=szshssdzzp
痨=dhpdhhssdzzp
铹=phhhzhssdzzp
醪=hszpzhhzdhzdhpdppp
老=hshppz
佬=pshshppz
姥=zphhshppz
荖=hsshshppz
栳=hspdhshppz
铑=phhhzhshppz
潦=ddhhpddpszhhspd
橑=hspdhpddpszhhspd
涝=ddhhssdzzp
烙=dppdpzdszh
耢=hhhspdhssdzzp
酪=hszpzhhpzdszh
嫪=zphzdhzdhpdppp
肋=pzhhzp
仂=pszp
乐=pzspd
叻=szhzp
玏=hhshzp
泐=ddhzszp
砳=hpszhhpszh
簕=phdphdhsshszhhszp
鳓=pzszhshhhsshszhhszp
了=zs
饹=pzzpzdszh
勒=hsshszhhszp
雷=hdzsddddszhsh
嫘=zphszhshzzdspd
缧=zzhszhshzzdspd
擂=hshhdzsddddszhsh
檑=hspdhdzsddddszhsh
礌=hpszhhdzsddddszhsh
镭=phhhzhdzsddddszhsh
羸=dhzszhpzhhdphhhspzd
罍=szhshszhshszhshphhszs
耒=hhhspd
诔=dzhhhspd
垒=zdzdzdhsh
磊=hpszhhpszhhpszh
蕾=hsshdzsddddszhsh
儡=psszhshszhshszhsh
癗=dhpdhhdzsddddszhsh
藟=hssszhshszhshszhsh
泪=ddhszhhh
类=dphspdhpd
累=szhshzzdspd
酹=hszpzhhpddphsd
嘞=szhhsshszhhszp
崚=szshshpdpzd
塄=hshszsshdhzp
棱=hspdhshpdpzd
楞=hspdszsshdhzp
冷=dhpddzd
堎=hshhshpdpzd
愣=ddsszsshdhzp
哩=szhszhhshh
厘=hpszhhshh
狸=pzpszhhshh
离=dhpdzsszzd
骊=zzhhszdszd
梨=phspdsshspd
犁=phspdssphhs
喱=szhhpszhhshh
鹂=hszdszdpzdzh
漓=ddhdhpdzsszzd
缡=zzhdhpdzsszzd
蓠=hssdhpdzsszzd
蜊=szhshdphspdss
嫠=hhspdphpdhpzph
璃=hhshdhpdzsszzd
鲡=pzszhshhhszdszd
黎=phspdpzppdsdhpd
篱=phdphddhpdzsszzd
罹=szsshddspsdhhhsh
醨=hszpzhhdhpdzsszzd
嚟=szhphspdpzppdsdhpd
藜=hssphspdpzppdsdhpd
黧=phspdpzpszdphshhdddd
蠡=zzhpzpppdszhshdszhshd
礼=dzsdz
李=hspdzsh
里=szhhshh
俚=psszhhshh
峛=szshpzdss
娌=zphszhhshh
浬=ddhszhhshh
逦=hszdszddzd
理=hhshszhhshh
锂=phhhzszhhshh
鲤=pzszhshhszhhshh
澧=ddhszhsshhszhdph
醴=hszpzhhszhsshhszhdph
鳢=pzszhshhszhsshhszhdph
力=zp
历=hpzp
厉=hphzp
立=dhdph
吏=hszhpd
朸=hspdzp
丽=hszdszd
利=phspdss
励=hphzpzp
呖=szhhpzp
坜=hshhpzp
沥=ddhhpzp
苈=hsshpzp
例=pshpzdss
戾=dzhphpdd
枥=hspdhpzp
疠=dhpdhhzp
隶=zhhsdhpd
俐=psphspdss
俪=pshszdszd
栎=hspdpzspd
疬=dhpdhhpzp
荔=hsszpzpzp
轹=hzshpzspd
郦=hszdszdzs
栗=hszsshhspd
猁=pzpphspdss
珕=hhshzpzpzp
砺=hpszhhphzp
砾=hpszhpzspd
莅=hsspsdhdph
莉=hssphspdss
唳=szhdzhphpdd
笠=phdphddhdph
粒=dphspddhdph
粝=dphspdhphzp
蛎=szhshdhphzp
傈=pshszsshhspd
凓=dhhszsshhspd
痢=dhpdhphspdss
詈=szsshdhhhszh
跞=szhshshpzspd
雳=hdzsddddhpzp
溧=ddhhszsshhspd
篥=phdphdhszsshhspd
俩=pshszpdpd
奁=hpdhpdz
连=hzhsdzd
帘=ddzpdszs
怜=ddspddzd
涟=ddhhzhsdzd
莲=hsshzhsdzd
梿=hspdhzhsdzd
联=hsshhhdphhpd
裢=dzspdhzhsdzd
廉=dhpdphzhhsspd
磏=hpszhdphzhhsspd
鲢=pzszhshhhzhsdzd
濂=ddhdhpdphzhhsspd
镰=phhhzdhpdphzhhsspd
蠊=szhshddhpdphzhhsspd
敛=pdhddphphpd
琏=hhshhzhsdzd
脸=pzhhpdhddph
裣=dzspdpdhddph
蔹=hsspdhddphphpd
练=zzhhzzpd
炼=dppdhzzpd
恋=dhsspddzdd
浰=ddhphspdss
殓=hpzdpdhddph
链=phhhzhzhsdzd
楝=hspdhszdphspd
瑓=hhshhszdphspd
潋=ddhpdhddphphpd
良=dzhhzpd
俍=psdzhhzpd
凉=dhdhszhspd
梁=ddhzpddhspd
椋=hspddhszhspd
辌=hzshdhszhspd
粮=dphspddzhhzpd
粱=ddhzpdddphspd
墚=hshddhzpddhspd
踉=szhshshdzhhzpd
两=hszpdpd
魉=pszhhpzzdhszpdpd
亮=dhszhdzpz
悢=ddsdzhhzpd
谅=dzdhszhspd
辆=hzshhszpdpd
晾=szhhdhszhspd
量=szhhhszhhshh
撩=hshhpddpszhhspd
蹽=szhshshhpddpszhhspd
辽=zsdzd
疗=dhpdhzs
聊=hsshhhpzpzs
僚=pshpddpszhhspd
寥=ddzzdhzdhpdppp
漻=ddhzdhzdhpdppp
嘹=szhhpddpszhhspd
嫽=zphhpddpszhhspd
寮=ddzhpddpszhhspd
敹=shdzpdphspdphpd
獠=pzphpddpszhhspd
缭=zzhhpddpszhhspd
燎=dppdhpddpszhhspd
鹩=hpddpszhhspdpzdzh
簝=phdphdhpddpszhhspd
髎=szzdzszhhzdhzdhpdppp
钌=phhhzzs
蓼=hsszdhzdhpdppp
憭=ddshpddpszhhspd
尥=hpzpzd
料=dphspdddhs
廖=dhpzdhzdhpdppp
撂=hshszhshpzdszh
瞭=szhhhhpddpszhhspd
镣=phhhzhpddpszhhspd
咧=szhhpzdss
列=hpzdss
劣=spdpzp
冽=dhhpzdss
洌=ddhhpzdss
埒=hshpddphsd
烈=hpzdssdddd
捩=hshdzhphpdd
猎=pzphsshszhh
脟=pzhhpddphsd
裂=hpzdssdhpzpd
趔=hshshpdhpzdss
躐=szhshshzzzszpdhzddzddz
鬣=hshhhzdpppzzzszpdhzddzddz
拎=hshpddzd
邻=pddzdzs
林=hspdhspd
临=ssphdszsh
冧=dzhspdhspd
啉=szhhspdhspd
淋=ddhhspdhspd
琳=hhshhspdhspd
粦=dphspdpzdhzs
箖=phdphdhspdhspd
粼=dphspdpzdhzszz
嶙=szsdphspdpzdhzs
潾=ddhdphspdpzdhzs
遴=dphspdpzdhzsdzd
璘=hhshdphspdpzdhzs
辚=hzshdphspdpzdhzs
霖=hdzsddddhspdhspd
瞵=szhhhdphspdpzdhzs
磷=hpszhdphspdpzdhzs
翷=dphspdpzdhzszdhzdh
鳞=pzszhshhdphspdpzdhzs
麟=dhpzsshhzpzdphspdpzdhzs
凛=dhdhszszhhhhspd
廪=dhpdhszszhhhhspd
懔=ddsdhszszhhhhspd
檩=hspddhszszhhhhspd
吝=dhpdszh
赁=psphshszpd
蔺=hssdszpsdhhhsh
膦=pzhhdphspdpzdhzs
躏=szhshshhssdszpsdhhhsh
伶=pspddzd
灵=zhhdppd
囹=szpddzdh
坽=hshpddzd
姈=zphpddzd
泠=ddhpddzd
苓=hsspddzd
昤=szhhpddzd
柃=hspdpddzd
玲=hhshpddzd
瓴=pddzdhzzd
凌=dhhshpdpzd
铃=phhhzpddzd
陵=zshshpdpzd
鸰=pddzdpzdzh
棂=hspdzhhdppd
绫=zzhhshpdpzd
羚=dphhhppddzd
翎=pddzdzdhzdh
聆=hsshhhpddzd
舲=ppzdhdpddzd
菱=hsshshpdpzd
蛉=szhshdpddzd
祾=dzsdhshpdpzd
零=hdzsddddpddzd
龄=shshpdzspddzd
澪=ddhhdzsddddpddzd
鲮=pzszhshhhshpdpzd
酃=hdzsddddszhszhszhzs
岭=szspddzd
领=pddzdhpszpd
令=pddzd
另=szhzp
呤=szhpddzd
溜=ddhpzdzpszhsh
熘=dppdpzdzpszhsh
刘=dhpdss
浏=ddhdhpdss
流=ddhdhzdpsz
留=pzdzpszhsh
琉=hhshdhzdpsz
硫=hpszhdhzdpsz
旒=dhzpphdhzdpsz
遛=pzdzpszhshdzd
馏=pzzpzdzpszhsh
骝=zzhpzdzpszhsh
榴=hspdpzdzpszhsh
瑠=hhshpzdzpszhsh
飗=pzpdpzdzpszhsh
瑬=ddhdhzdpszhhshd
瘤=dhpdhpzdzpszhsh
镏=phhhzpzdzpszhsh
鹠=pzdzpszhshpzdzh
疁=szhshzdhzdhpdppp
镠=phhhzzdhzdhpdppp
鎏=ddhdhzdpszpdhhsdph
柳=hspdpzpzs
珋=hhshpzpzs
绺=zzhpzdsdszh
锍=phhhzdhzdpsz
罶=szsshpzdzpszhsh
六=dhpd
鹨=zdhzdhpdppppzdzh
龙=hpzpd
咙=szhhpzpd
泷=ddhhpzpd
茏=hsshpzpd
昽=szhhhpzpd
栊=hspdhpzpd
珑=hhshhpzpd
胧=pzhhhpzpd
眬=szhhhhpzpd
砻=hpzpdhpszh
笼=phdphdhpzpd
聋=hpzpdhsshhh
隆=zspzdhphhsh
漋=ddhzspzdhphhsh
癃=dhpdhzspzdhphhsh
窿=ddzpdzspzdhphhsh
陇=zshpzpd
垄=hpzpdhsh
垅=hshhpzpd
拢=hshhpzpd
哢=szhhhshhps
剅=hszhdphss
娄=dphspdzph
偻=psdphspdzph
喽=szhdphspdzph
溇=ddhdphspdzph
蒌=hssdphspdzph
楼=hspddphspdzph
耧=hhhspddphspdzph
蝼=szhshddphspdzph
髅=szzdzszhhdphspdzph
嵝=szsdphspdzph
搂=hshdphspdzph
篓=phdphddphspdzph
陋=zshszpdz
漏=ddhzhphszsdddd
瘘=dhpdhdphspdzph
镂=phhhzdphspdzph
噜=szhpzszhshhszhh
撸=hshpzszhshhszhh
卢=shzhp
庐=dhpdzhp
芦=hssdzhp
垆=hshshzhp
泸=ddhshzhp
炉=dppddzhp
栌=hspdshzhp
胪=pzhhshzhp
轳=hzshshzhp
鸬=shzhppzdzh
舻=ppzdhdshzhp
颅=shzhphpszpd
鲈=pzszhshhshzhp
卤=shszpdh
虏=shzphzzp
掳=hshshzphzzp
鲁=pzszhshhszhh
澛=ddhpzszhshhszhh
橹=hspdpzszhshhszhh
镥=phhhzpzszhshhszhh
甪=ppzhhs
陆=zshhszs
录=zhhsdhpd
赂=szpdpzdszh
辂=hzshpzdszh
渌=ddhzhhsdhpd
菉=hsszhhsdhpd
逯=zhhsdhpddzd
鹿=dhpzsshhzpz
琭=hhshzhhsdhpd
禄=dzsdzhhsdhpd
僇=pszdhzdhpdppp
勠=zdhzdhpdpppzp
碌=hpszhzhhsdhpd
稑=phspdhshpdhsh
路=szhshshpzdszh
漉=ddhdhpzsshhzpz
箓=phdphdzhhsdhpd
戮=zdhzdhpdppphzpd
辘=hzshdhpzsshhzpz
潞=ddhszhshshpzdszh
蕗=hssszhshshpzdszh
璐=hhshszhshshpzdszh
簏=phdphddhpzsshhzpz
鹭=szhshshpzdszhpzdzh
麓=hspdhspddhpzsshhzpz
露=hdzsddddszhshshpzdszh
氇=phhzpzszhshhszhh
驴=zzhdzhp
闾=dszszhszh
榈=hspddszszhszh
吕=szhszh
侣=psszhszh
捋=hshpddphsd
旅=dhzpphpzpd
梠=hspdszhszh
稆=phspdszhszh
铝=phhhzszhszh
屡=zhpdphspdzph
缕=zzhdphspdzph
膂=dhzpphpzpdszhh
褛=dzspddphspdzph
履=zhpppsphszhhpzd
垏=hshzhhhhs
律=ppszhhhhs
虑=shzphzdzdd
率=dhzzddhpdhs
绿=zzhzhhsdhpd
氯=phhzzhhsdhpd
葎=hssppszhhhhs
滤=ddhshzphzdzdd
娈=dhsspdzph
孪=dhsspdzsh
峦=dhsspdszs
挛=dhsspdphhs
栾=dhsspdhspd
鸾=dhsspdpzdzh
脔=dhsspdszpdpd
滦=ddhdhsspdhspd
銮=dhsspdpdhhsdph
卵=pzdpzsd
乱=phsszhz
掠=hshdhszhspd
略=szhshpzdszh
锊=phhhzpddphsd
圙=szpdhpszsshhhh
抡=hshpdpz
仑=pdpz
伦=pspdpz
囵=szpdpzh
沦=ddhpdpz
纶=zzhpdpz
轮=hzshpdpz
论=dzpdpz
罗=szsshpzd
啰=szhszsshpzd
猡=pzpszsshpzd
脶=pzhhszhszpd
萝=hssszsshpzd
逻=szsshpzddzd
椤=hspdszsshpzd
锣=phhhzszsshpzd
箩=phdphdszsshpzd
骡=zzhszhshzzdspd
螺=szhshdszhshzzdspd
攞=hshszsshzzddddpsdhhhsh
倮=psszhhhspd
蓏=hssppzddppzdd
裸=dzspdszhhhspd
瘰=dhpdhszhshzzdspd
蠃=dhzszhpzhhszhshdpzd
泺=ddhpzspd
洛=ddhpzdszh
络=zzhpzdszh
荦=hssdzphhs
骆=zzhpzdszh
珞=hhshpzdszh
落=hssddhpzdszh
摞=hshszhshzzdspd
漯=ddhszhshzzdspd
雒=pzdszhpsdhhhsh
呣=szhzzdhd
妈=zphzzh
孖=zshzsh
嬷=zphdhphspdhspdpzd
麻=dhphspdhspd
蟆=szhshdhssszhhhpd
马=zzh
玛=hhshzzh
码=hpszhzzh
蚂=szhshdzzh
犸=pzpzzh
杩=hspdzzh
祃=dzsdzzh
骂=szhszhzzh
唛=szhhhshpzd
吗=szhzzh
嘛=szhdhphspdhspd
埋=hshszhhshh
霾=hdzsddddpddpzppszhhshh
买=zddhpd
荬=hsszddhpd
劢=hzpzp
迈=hzpdzd
麦=hhshpzd
卖=hszddhpd
脉=pzhhdzzpd
嫚=zphszhhszsshzd
颟=hsshszpdpdhpszpd
蛮=dhsspdszhshd
谩=dzszhhszsshzd
馒=pzzszhhszsshzd
瞒=szhhhhsshszpdpd
鞔=hsshszhhspzszhpz
蹒=szhshshhsshszpdpd
鳗=pzszhshhszhhszsshzd
鬘=hshhhzdpppszhhszsshzd
满=ddhhsshszpdpd
螨=szhshdhsshszpdpd
曼=szhhszsshzd
墁=hshszhhszsshzd
幔=szsszhhszsshzd
慢=ddsszhhszsshzd
漫=ddhszhhszsshzd
缦=zzhszhhszsshzd
蔓=hssszhhszsshzd
镘=phhhzszhhszsshzd
牤=phshdhz
邙=dhzzs
忙=ddsdhz
芒=hssdhz
尨=hpzpppd
杧=hspddhz
氓=dhzzhzhz
盲=dhzszhhh
茫=hssddhdhz
牻=phshhpzpppd
硭=hpszhhssdhz
莽=hsshpddhps
漭=ddhhsshpddhps
蟒=szhshdhsshpddhps
猫=pzphssszhsh
毛=phhz
矛=zdzsp
牦=phshphhz
茅=hsszdzsp
茆=hsspzpzs
旄=dhzpphphhz
锚=phhhzhssszhsh
髦=hshhhzdpppphhz
蝥=zdzspphpdszhshd
蟊=zdzspszhshdszhshd
冇=hpsz
卯=pzpzs
峁=szspzpzs
泖=ddhpzpzs
昴=szhhpzpzs
铆=phhhzpzpzh
芼=hssphhz
茂=hsshpzpd
冒=szhhszhhh
眊=szhhhphhz
贸=pzdzpszpd
耄=hshppzphhz
袤=dhzdzsppzpd
帽=szsszhhszhhh
鄚=hssszhhhpdzs
楙=hspdzdzsphspd
瑁=hhshszhhszhhh
瞀=zdzspphpdszhhh
貌=pddpzpppszhhpz
懋=hspdzdzsphspddzdd
么=pzd
没=ddhpzzd
枚=hspdphpd
玫=hhshphpd
眉=zshpszhhh
莓=hssphzzdhd
梅=hspdphzzdhd
郿=zshpszhhhzs
媒=zphhsshhhspd
嵋=szszshpszhhh
湄=ddhzshpszhhh
楣=hspdzshpszhhh
煤=dppdhsshhhspd
瑂=hhshzshpszhhh
槑=szhhspdszhhspd
酶=hszpzhhphzzdhd
镅=phhhzzshpszhhh
鹛=zshpszhhhpzdzh
霉=hdzsddddphzzdhd
每=phzzdhd
美=dphhshhpd
浼=ddhpzszhpz
媄=zphdphhshhpd
渼=ddhdphhshhpd
镁=phhhzdphhshhpd
妹=zphhhspd
昧=szhhhhspd
袂=dzspdzhpd
媚=zphzshpszhhh
寐=ddzzshphhspd
魅=pszhhpzzdhhspd
门=dsz
扪=hshdsz
钔=phhhzdsz
亹=dhpshhszhszhzhhdzszhhh
闷=dszdzdd
焖=dppddszdzdd
懑=ddhhsshszpdpddzdd
们=psdsz
擝=hshszhhpzhhszssh
虻=szhshddhz
萌=hssszhhpzhh
盟=szhhpzhhszssh
蒙=hssdzhhpzpppd
甍=hssszsshdzhzzd
瞢=hssszsshdzszhhh
幪=szshssdzhhpzpppd
濛=ddhhssdzhhpzpppd
朦=pzhhhssdzhhpzpppd
檬=hspdhssdzhhpzpppd
礞=hpszhhssdzhhpzpppd
鹲=hssdzhhpzpppdpzdzh
艨=ppzdhdhssdzhhpzpppd
艨=ppzdhdhssdzhhpzpppd
勐=zshszsshzp
猛=pzpzshszssh
锰=phhhzzshszssh
艋=ppzdhdzshszssh
蜢=szhshdzshszssh
獴=pzphssdzhhpzpppd
懵=ddshssszsshdzszhhh
蠓=szhshdhssdzhhpzpppd
孟=zshszssh
梦=hspdhspdpzd
咪=szhdphspd
眯=szhhhdphspd
弥=zhzpzspd
祢=dzsdpzspd
迷=dphspddzd
猕=pzpzhzpzspd
谜=dzdphspddzd
醚=hszpzhhdphspddzd
糜=dhphspdhspddphspd
縻=dhphspdhspdzzdspd
麋=dhpzsshhzpzdphspd
靡=dhphspdhspdshhhshhh
蘼=hssdhphspdhspdshhhshhh
醾=hszpzhhdhphspdhspddphspd
米=dphspd
芈=shshhhs
沵=ddhpzspd
弭=zhzhsshhh
洣=ddhdphspd
敉=dphspdphpd
脒=pzhhdphspd
汨=ddhszhh
宓=ddzdzdpd
泌=ddhdzdpd
觅=pddpszpz
祕=dzsddzdpd
秘=phspddzdpd
密=ddzdzdpdszs
幂=dzszhhhpdszs
谧=dzdzdpdszssh
嘧=szhddzdzdpdszs
蜜=ddzdzdpdszhshd
眠=szhhhzhzhz
绵=zzhpszhhszs
棉=hspdpszhhszs
丏=hszz
免=pzszhpz
沔=ddhhszz
黾=szhszhhz
勉=pzszhpzzp
眄=szhhhhszz
娩=zphpzszhpz
偭=pshpszsshhh
冕=szhhpzszhpz
勔=hpszsshhhzp
渑=ddhszhszhhz
愐=ddshpszsshhh
湎=ddhhpszsshhh
缅=zzhhpszsshhh
腼=pzhhhpszsshhh
面=hpszsshhh
喵=szhhssszhsh
苗=hssszhsh
描=hshhssszhsh
瞄=szhhhhssszhsh
鹋=hssszhshpzdzh
杪=hspdspdp
眇=szhhhspdp
秒=phspdspdp
淼=szpdszpdszpd
渺=ddhszhhhspdp
缈=zzhszhhhspdp
藐=hsspddpzpppszhhpz
邈=pddpzpppszhhpzdzd
妙=zphspdp
庙=dhpszhsh
乜=zz
咩=szhdphhhs
灭=hdppd
搣=hshhphdppdzpd
蔑=hssszsshhpdzpd
篾=phdphdszsshhpdzpd
民=zhzhz
岷=szszhzhz
忞=dhpddzdd
旻=szhhdhpd
苠=hsszhzhz
珉=hhshzhzhz
缗=zzhzhzhzszhh
碈=hpszhpzhzszhh
皿=szssh
闵=dszdhpd
抿=hshzhzhz
泯=ddhzhzhz
闽=dszszhshd
悯=ddsdszdhpd
敏=phzzdhdphpd
湣=ddhzhzhzszhh
愍=zhzhzphpddzdd
慜=phzzdhdphpddzdd
鳘=phzzdhdphpdpzszhshh
名=pzdszh
明=szhhpzhh
鸣=szhpzdzh
洺=ddhpzdszh
茗=hsspzdszh
冥=dzszhhdhpd
铭=phhhzpzdszh
溟=ddhdzszhhdhpd
蓂=hssdzszhhdhpd
暝=szhhdzszhhdhpd
瞑=szhhhdzszhhdhpd
螟=szhshddzszhhdhpd
酩=hszpzhhpzdszh
命=pdhszhzs
谬=dzzdhzdhpdppp
摸=hshhssszhhhpd
尛=spdspdspd
谟=dzhssszhhhpd
嫫=zphhssszhhhpd
馍=pzzhssszhhhpd
摹=hssszhhhpdphhs
模=hspdhssszhhhpd
膜=pzhhhssszhhhpd
麽=dhphspdhspdpzd
摩=dhphspdhspdphhs
磨=dhphspdhspdhpszh
蘑=hssdhphspdhspdhpszh
魔=dhphspdhspdpszhhpzzd
抹=hshhhspd
末=hhspd
殁=hpzdpzzd
沫=ddhhhspd
茉=hsshhspd
陌=zshpszhh
秣=phspdhhspd
莫=hssszhhhpd
寞=ddzhssszhhhpd
漠=ddhhssszhhhpd
蓦=hssszhhhpdzzh
貊=pddpzpphpszhh
靺=hsshszhhshhspd
瘼=dhpdhhssszhhhpd
镆=phhhzhssszhhhpd
墨=szdphshhddddhsh
默=szdphshhddddhpdd
貘=pddpzpphssszhhhpd
藦=hssdhphspdhspdphhs
耱=hhhspddhphspdhspdhpszh
哞=szhzdphhs
牟=zdphhs
侔=pszdphhs
眸=szhhhzdphhs
谋=dzhsshhhspd
蛑=szhshdzdphhs
缪=zzhzdhzdhpdppp
鍪=zdzspphpdpdhhsdph
某=hsshhhspd
毪=phhzzdphhs
母=zzdhd
亩=dhszhsh
牡=phshhsh
姆=zphzzdhd
拇=hshzzdhd
木=hspd
仫=pspzd
目=szhhh
沐=ddhhspd
牧=phshphpd
苜=hssszhhh
莯=hssddhhspd
钼=phhhzszhhh
募=hssszhhhpdzp
墓=hssszhhhpdhsh
幕=hssszhhhpdszs
睦=szhhhhshpdhsh
慕=hssszhhhpdsddd
暮=hssszhhhpdszhh
穆=phspdpszhhspdppp
嗯=szhszhpdhdzdd
拿=pdhszhphhs
嗱=szhpdhszhphhs
镎=phhhzpdhszhphhs
乸=zszzzdhd
哪=szhzhhpzs
雫=hdzsddddhsd
那=zhhpzs
呐=szhszpd
纳=zzhszpd
肭=pzhhszpd
娜=zphzhhpzs
衲=dzspdszpd
钠=phhhzszpd
捺=hshhpdhhspd
乃=zp
奶=zphzp
艿=hsszp
氖=phhzzp
妳=zphpzspd
迺=hszpzhdzd
奈=hpdhhspd
柰=hspdhhspd
耏=hpszssppp
耐=hpszsshsd
萘=hsshpdhhspd
鼐=zpszhhhzhpshsz
囡=szzphh
男=szhshzp
南=hsszdphhs
难=zdpsdhhhsh
喃=szhhsszdphhs
楠=hspdhsszdphhs
赧=hshpspdzszd
萳=hsshsszdphhs
腩=pzhhhsszdphhs
蝻=szhshdhsszdphhs
婻=zphhsszdphhs
囔=szhhszhsdzszhszhhhsshpzpd
囊=hszhsdzszhszhhhsshpzsd
馕=pzzhszhsdzszhszhhhsshpzpd
曩=szhhdhszhszhhhsshpzpd
攮=hshhszhsdzszhszhhhsshpzpd
齉=pszhhhszhshhpshszhsdzszhszhhhsshpzsd
孬=hpsdzphzsh
呶=szhzphzd
挠=hshhzphpz
峱=pzpzshhszs
硇=hpszhpszpdh
铙=phhhzhzphpz
猱=pzpzdzsphspd
蛲=szhshdhzphpz
垴=hshdhpdzs
恼=ddsdhpdzs
脑=pzhhdhpdzs
嫐=zphszhshzpzph
瑙=hhshzzzpszpdh
闹=dszdhszs
淖=ddhshszhhhs
臑=pzhhhdzsddddhpszss
讷=dzszpd
呢=szhzhppz
馁=pzzpddpzph
内=szpd
恁=psphshdzdd
嫩=zphhszhspdphpd
能=zdszhhpzpz
妮=zphzhppz
尼=zhppz
坭=hshzhppz
怩=ddszhppz
泥=ddhzhppz
倪=pspshzhhpz
铌=phhhzzhppz
婗=zphpshzhhpz
猊=pzppshzhhpz
霓=hdzsddddpshzhhpz
鲵=pzszhshhpshzhhpz
麑=dhpzsshhzpzpshzhhpz
你=pspzspd
拟=hshzdpd
旎=dhzpphzhppz
薿=hsspzphhpdzdzshpd
氼=szpdpd
伲=pszhppz
昵=szhhzhppz
逆=dphzspdzd
匿=hhsshpszhz
溺=ddhzhzdhzhzdh
睨=szhhhpshzhhpz
腻=pzhhhhhszpdzd
拈=hshshszh
蔫=hsshshshhzdddd
年=phhshs
鲇=pzszhshhshszh
鲶=pzszhshhpddzdzdd
黏=phspdpdsdhpdshszh
捻=hshpddzdzdd
辇=hhpdhhpdhzhs
辗=hzshzhphsshzpd
撚=hshpzddhpdddddd
撵=hshhhpdhhpdhzhs
碾=hpszhzhphsshzpd
廿=hssh
念=pddzdzdd
唸=szhpddzdzdd
埝=hshpddzdzdd
娘=zphdzhhzpd
嬢=zphdhpdhhsshpzpd
孃=zphdhszhszhhhsshpzpd
酿=hszpzhhdzhhzpd
鸟=pzdzh
茑=hsspzdzh
袅=pzdzdhpzpd
嬲=szhshzpzphszhshzp
尿=zhpszpd
脲=pzhhzhpszpd
捏=hshszhhhsh
苶=hsspdspd
陧=zsszhhhsh
涅=ddhszhhhsh
聂=hsshhhzdzd
臬=pszhhhhspd
啮=szhshshpdzs
惗=ddspddzdzdd
菍=hsspddzdzdd
嗫=szhhsshhhzdzd
嵲=szspszhhhhspd
镊=phhhzhsshhhzdzd
镍=phhhzpszhhhhspd
颞=hsshhhzdzdhpszpd
蹑=szhshshhsshhhzdzd
孽=hsspszhzhdhdphhszsh
蘖=hsspszhzhdhdphhshspd
糵=hsspszhzhdhdphhsdphspd
您=pspzspddzdd
宁=ddzhs
咛=szhddzhs
拧=hshddzhs
狞=pzpddzhs
苧=hssddzhs
柠=hspdddzhs
聍=hsshhhddzhs
甯=ddzdzddszhhs
凝=dhpzphhpdzdzshpd
佞=pshhzph
泞=ddhddzhs
妞=zphzshh
牛=phhs
忸=ddszshh
扭=hshzshh
狃=pzpzshh
纽=zzhzshh
钮=phhhzzshh
农=dzpzpd
侬=psdzpzpd
哝=szhdzpzpd
浓=ddhdzpzpd
脓=pzhhdzpzpd
秾=phspddzpzpd
弄=hhshhps
耨=hhhspdhphhzpdhsd
奴=zphzd
孥=zphzdzsh
驽=zphzdzzh
笯=phdphdzphzd
努=zphzdzp
弩=zphzdzhz
砮=zphzdhpszh
胬=zphzdszpdpd
怒=zphzddzdd
傉=pshphhzpdhsd
女=zph
钕=phhhzzph
恧=hpszssdzdd
朒=pzhhszpdpd
衄=pszsshzshh
暖=szhhpddphhpzd
疟=dhpdhhzh
虐=shzphzhzh
挪=hshzhhpzs
傩=pszdpsdhhhsh
诺=dzhsshpszh
喏=szhhsshpszh
搦=hshzhzdhzhzdh
锘=phhhzhsshpszh
懦=ddshdzsddddhpszss
糯=dphspdhdzsddddhpszss
喔=szhzhphzdhsh
噢=szhpszdphspdhpd
哦=szhphshzpd
讴=dzhpdz
沤=ddhhpdz
欧=hpdzpzpd
殴=hpdzpzzd
瓯=hpdzhzzd
鸥=hpdzpzdzh
呕=szhhpdz
偶=psszhhszshd
耦=hhhspdszhhszshd
藕=hsshhhspdszhhszshd
怄=ddshpdz
趴=szhshshpd
舥=ppzdhdzshz
啪=szhhshpszhh
葩=hsspszhhzshz
杷=hspdzshz
爬=ppsdzshz
琶=hhshhhshzshz
筢=phdphdhshzshz
潖=ddhhhshhhshzshz
帕=szspszhh
怕=ddspszhh
拍=hshpszhh
俳=psshhhshhh
徘=ppsshhhshhh
排=hshshhhshhh
牌=pshzpszhhphs
簰=phdphdpshzpszhhphs
哌=szhpppzpd
派=ddhpppzpd
湃=ddhphhphhhhs
蒎=hssddhpppzpd
潘=ddhpdphspdszhsh
攀=hspdpdpdhspdhpdphhs
爿=zshp
盘=ppzdhdszssh
槃=ppzdhdpzzdhspd
磐=ppzdhdpzzdhpszh
磻=hpszhpdphspdszhsh
蟠=szhshdpdphspdszhsh
判=dphhpss
泮=ddhdphhs
叛=dphhpppzd
盼=szhhhpdzp
畔=szhshdphhs
袢=dzspddphhs
襻=dzspdhspdpdpdhspdhpdphhs
乓=pshshd
雱=hdzsdddddhzp
滂=ddhdhdpdzdhzp
膖=pzhhpzdhhhsdzd
庞=dhphpzpd
厖=hphpzpppd
逄=pzdhzsdzd
旁=dhdpdzdhzp
螃=szhshddhdpdzdhzp
鳑=pzszhshhdhdpdzdhzp
耪=hhhspddhdpdzdhzp
胖=pzhhdphhs
抛=hshpzzp
脬=pzhhpddpzsh
刨=pzzhzss
咆=szhpzzhz
庖=dhppzzhz
狍=pzppzzhz
袍=dzspdpzzhz
匏=hpdhhzpzzhz
跑=szhshshpzzhz
泡=ddhpzzhz
炮=dppdpzzhz
疱=dhpdhpzzhz
呸=szhhpsdh
胚=pzhhhpsdh
衃=pszsshhpsd
醅=hszpzhhdhdphszh
陪=zsdhdphszh
培=hshdhdphszh
赔=szpddhdphszh
锫=phhhzdhdphszh
裴=shhhshhhdhpzpd
沛=ddhhszs
佩=pspzhszs
帔=szszpszd
旆=dhzpphhszs
珮=hhshpzhszs
配=hszpzhhzhz
辔=zzhhzhszzhszh
霈=hdzsddddddhhszh
喷=szhhshssszpd
盆=pdzpszssh
湓=ddhpdzpszssh
怦=ddshdphs
抨=hshhdphs
砰=hpszhhdphs
烹=dhszhzsdddd
嘭=szhhshszhdphppp
澎=ddhhshszhdphppp
芃=hsspzd
朋=pzhhpzhh
堋=hshpzhhpzhh
弸=zhzpzhhpzhh
彭=hshszhdphppp
棚=hspdpzhhpzhh
硼=hpszhpzhhpzhh
蓬=hsspzdhhhsdzd
鹏=pzhhpzhhpzdzh
篷=phdphdpzdhhhsdzd
膨=pzhhhshszhdphppp
蟛=szhshdhshszhdphppp
捧=hshhhhpdhhs
椪=hspddphssdph
碰=hpszhdphssdph
丕=hpsdh
伾=pshpsdh
批=hshhzpz
纰=zzhhzpz
邳=hpsdhzs
坯=hshhpsdh
披=hshzpszd
狉=pzphpsdh
砒=hpszhhzpz
铍=phhhzzpszd
劈=zhpszhdhdphhszp
噼=szhzhpszhdhdphhs
霹=hdzsddddzhpszhdhdphhs
皮=zpszd
芘=hsshzpz
枇=hspdhzpz
毗=szhshhzpz
疲=dhpdhzpszd
蚍=szhshdhzpz
郫=pszhhphszs
陴=zspszhhphs
啤=szhpszhhphs
埤=hshpszhhphs
琵=hhshhhshhzpz
脾=pzhhpszhhphs
鲏=pzszhshhzpszd
罴=szsshhshzddddd
蜱=szhshdpszhhphs
貔=pddpzpppszpdhhzpz
鼙=hshszhdphhszdpszhhphs
匹=hpzz
仳=pshzpz
圮=hshzhz
苉=hsshpzz
痞=dhpdhhpsdszh
癖=dhpdhzhpszhdhdphhs
嚭=hshszhdphszhhpsdszh
屁=zhphzpz
淠=ddhszhshhps
媲=zphpszpdhhzpz
睥=szhhhpszhhphs
辟=zhpszhdhdphhs
僻=pszhpszhdhdphhs
澼=ddhzhpszhdhdphhs
甓=zhpszhdhdphhshzzd
譬=zhpszhdhdphhsdhhhszh
偏=psdzhpszhss
犏=phshdzhpszhss
篇=phdphddzhpszhss
翩=dzhpszhsszdhzdh
骈=zzhdphhps
胼=pzhhdphhps
谝=dzdzhpszhss
楩=hspdpshszhhpd
蹁=szhshshdzhpszhss
片=pshz
骗=zzhdzhpszhss
剽=hszsshhhspdss
缥=zzhhszsshhhspd
飘=hszsshhhspdpzpd
螵=szhshdhszsshhhspd
嫖=zphhszsshhhspd
瓢=hszsshhhspdppzdd
薸=hssddhhszsshhhspd
殍=hpzdpddpzsh
瞟=szhhhhszsshhhspd
票=hszsshhhspd
嘌=szhhszsshhhspd
漂=ddhhszsshhhspd
氕=phhzp
撇=hshdpszspdphpd
瞥=dpszspdphpdszhhh
苤=hsshpsdh
姘=zphdphhps
拼=hshdphhps
玭=hhshhzpz
贫=pdzpszpd
嫔=zphddzpshshpd
频=shshspphpszpd
颦=shshspphpszpdpszhhphs
品=szhszhszh
榀=hspdszhszhszh
牝=phshpz
聘=hsshhhszhshhz
乒=pshshp
俜=psszhshhz
娉=zphszhshhz
涄=ddhszhshhz
砯=hpszhdszpd
平=hdphs
评=dzhdphs
凭=psphshpz
呯=szhhdphs
坪=hshhdphs
泙=ddhhdphs
苹=hsshdphs
屏=zhpdphhps
帡=szsdphhps
枰=hspdhdphs
洴=ddhdphhps
玶=hhshhdphs
荓=hssdphhps
瓶=dphhpshzzd
淜=ddhpzhhpzhh
萍=hssddhhdphs
蚲=szhshdhdphs
鲆=pzszhshhhdphs
钋=phhhzsd
坡=hshzpszd
泊=ddhpszhh
泼=ddhzpzdd
婆=ddhzpszdzph
鄱=pdphspdszhshzs
皤=pszhhpdphspdszhsh
叵=hszhz
钷=phhhzhszhz
笸=phdphdhszhz
颇=zpszdhpszpd
迫=pszhhdzd
珀=hhshpszhh
破=hpszhzpszd
粕=dphspdpszhh
酦=hszpzhhzpzdd
魄=pszhhpszhhpzzd
桲=hspdhsdzzsh
剖=dhdphszhss
抔=hshhpsd
掊=hshdhdphszh
裒=dhpshzhhpzpd
仆=pssd
扑=hshsd
噗=szhssdphdphhhpd
潽=ddhdphssdphszhh
匍=pzhszhhsd
莆=hsshszhhsd
脯=pzhhhszhhsd
菩=hssdhdphszh
葡=hsspzhszhhsd
蒱=hsshshhszhhsd
蒲=hssddhhszhhsd
酺=hszpzhhhszhhsd
墣=hshssdphdphhhpd
璞=hhshssdphdphhhpd
濮=ddhpsssdphdphhhpd
穙=phspdssdphdphhhpd
镤=phhhzssdphdphhhpd
朴=hspdsd
圃=szhszhhsdh
浦=ddhhszhhsd
普=dphssdphszhh
溥=ddhhszhhsdhsd
谱=dzdphssdphszhh
氆=phhzdphssdphszhh
镨=phhhzdphssdphszhh
蹼=szhshshssdphdphhhpd
铺=phhhzhszhhsd
瀑=ddhszhhhsshpdsdhpd
曝=szhhszhhhsshpdsdhpd
巭=hshzphhpd
七=hz
沏=ddhhzzp
妻=hzhhszph
柒=ddhhzhspd
凄=dhhzhhszph
栖=hspdhszpzh
桤=hspdszszhz
郪=hzhhszphzs
戚=hpshhspdzpd
萋=hsshzhhszph
期=hsshhhpdpzhh
欺=hsshhhpdpzpd
嘁=szhhpshhspdzpd
漆=ddhhspdpdsdhpd
槭=hspdhpshhspdzpd
蹊=szhshshpddpzzdhpd
亓=hhps
祁=dzsdzs
齐=dhpdps
圻=hshpphs
岐=szshszd
芪=hsspzhz
其=hsshhhpd
奇=hpdhszhs
歧=shshhszd
祇=dzsdpzhz
祈=dzsdpphs
俟=pszdphhpd
耆=hshppzszhh
脐=pzhhdhpdps
颀=pphshpszpd
埼=hshhpdhszhs
崎=szshpdhszhs
淇=ddhhsshhhpd
畦=szhshhshhsh
萁=hsshsshhhpd
跂=szhshshhszd
骐=zzhhsshhhpd
骑=zzhhpdhszhs
棋=hspdhsshhhpd
琦=hhshhpdhszhs
琪=hhshhsshhhpd
祺=dzsdhsshhhpd
蛴=szhshddhpdps
愭=ddshshppzszhh
碁=hsshhhpdhpszh
锜=phhhzhpdhszhs
旗=dhzpphhsshhhpd
綦=hsshhhpdzzdspd
蜞=szhshdhsshhhpd
蕲=hssdpszhhhspphs
鲯=pzszhshhhsshhhpd
鳍=pzszhshhhshppzszhh
麒=dhpzsshhzpzhsshhhpd
乞=phz
企=pdshsh
屺=szszhz
岂=szszhz
芑=hsszhz
启=dzhpszh
呇=szpdszh
杞=hspdzhz
玘=hhshzhz
起=hshshpdzhz
婍=zphhpdhszhs
绮=zzhhpdhszhs
棨=dzhpphpdhspd
綮=dzhpphpdzzdspd
气=phhz
讫=dzphz
汔=ddhphz
迄=phzdzd
弃=dhzdhps
汽=ddhphhz
泣=ddhdhdph
炁=hzpzdddd
契=hhhszphpd
砌=hpszhhzzp
葺=hssszhhsshhh
碛=hpszhhhshszpd
碶=hpszhhhhszphpd
器=szhszhhpddszhszh
憩=phsszhpszhhhdzdd
磜=hpszhpzddzdhhspd
掐=hshpzpshzhh
袷=dzspdpdhszh
葜=hsshhhszphpd
拤=hshshhsd
恰=ddspdhszh
洽=ddhpdhszh
髂=szzdzszhhddzpzdszh
千=phs
仟=psphs
阡=zsphs
圲=hshphs
扦=hshphs
芊=hssphs
迁=phsdzd
佥=pdhddph
岍=szshhps
杄=hspdphs
汧=ddhhhps
钎=phhhzphs
牵=hpddzphhs
悭=ddssszdhsh
铅=phhhzpzszh
谦=dzdphzhhsspd
愆=ppsddhhhsdzdd
签=phdphdpdhddph
骞=ddzhhsshpdzzh
鹐=pzpshzhhpzdzh
搴=ddzhhsshpdphhs
褰=ddzhhsshpddhpzpd
孅=zphpdpdhshhhshhhhzpd
前=dphszhhss
钤=phhhzpddz
虔=shzphzdhpd
钱=phhhzhhzpd
钳=phhhzhsshh
乾=hsszhhhsphz
掮=hshdzhpszhh
靬=hsshszhhshhs
墘=hshhsszhhhsphz
潜=ddhhhpdhhpdszhh
黔=szdphshhddddpddz
浅=ddhhhzpd
肷=pzhhpzpd
遣=szhshszhzhdzd
谴=dzszhshszhzhdzd
缱=zzhszhshszhzhdzd
欠=pzpd
芡=hsspzpd
茜=hsshszpzh
倩=pshhshszhh
堑=hzshpphshsh
嵌=szshsshhpzpd
椠=hzshpphshspd
慊=ddsdphzhhsspd
蒨=hsspshhshszhh
歉=dphzhhsspdpzpd
呛=szhpdzz
羌=dphhhpz
戕=zshphzpd
戗=pdzzhzpd
枪=hspdpdzz
玱=hhshpdzz
跄=szhshshpdzz
腔=pzhhddzpdhsh
蜣=szhshddphhhpz
锖=phhhzhhshszhh
锵=phhhzdhspzdhsd
镪=phhhzzhzszhszhshd
强=zhzszhszhshd
墙=hshhsdphszszhh
嫱=zphhsdphszszhh
蔷=hsshsdphszszhh
樯=hspdhsdphszszhh
蔃=hsszhzszhszhshd
抢=hshpdzz
羟=dphhhpzdhsh
襁=dzspdzhzszhszhshd
炝=dppdpdzz
悄=ddssdpszhh
硗=hpszhhzphpz
跷=szhshshhzphpz
劁=psdhhhshddddss
敲=dhszhszszhshzd
锹=phhhzphspddppd
橇=hspdphhzphhzphhz
缲=zzhszhszhszhhspd
乔=phpdps
侨=psphpdps
荞=hssphpdps
桥=hspdphpdps
硚=hpszhphpdps
谯=dzpsdhhhshdddd
憔=ddspsdhhhshdddd
鞒=hsshszhhsphpdps
樵=hspdpsdhhhshdddd
瞧=szhhhpsdhhhshdddd
巧=hshhz
愀=ddsphspddppd
俏=pssdpszhh
诮=dzsdpszhh
峭=szssdpszhh
窍=ddzpdhshhz
翘=hzphpzzdhzdh
撬=hshphhzphhzphhz
鞘=hsshszhhssdpszhh
癿=pszhhz
且=szhhh
切=hzzp
妾=dhdphzph
怯=ddshshzd
郄=pdhpzdzs
窃=ddzpdhzzp
挈=hhhszpphhs
惬=ddshhdphpdz
箧=phdphdhhdphpdz
锲=phhhzhhhszphpd
亲=dhdphhspd
侵=pszhhdzzd
钦=phhhzpzpd
衾=pddzdhpzpd
骎=zzhzhhdzzd
嵚=szsphhhzpzpd
芩=hsspddz
芹=hsspphs
秦=hhhpdphspd
琴=hhshhhshpddz
禽=pddhpdzsszzd
勤=hsshszhhhshzp
嗪=szhhhhpdphspd
溱=ddhhhhpdphspd
慬=ddshsshszhhhsh
噙=szhpddhpdzsszzd
擒=hshpddhpdzsszzd
檎=hspdpddhpdzsszzd
螓=szhshdhhhpdphspd
锓=phhhzzhhdzzd
寝=ddzdhszhhdzzd
吣=szhdzdd
沁=ddhdzdd
揿=hshphhhzpzpd
青=hhshszhh
氢=phhzzdhsh
轻=hzshzdhsh
倾=pshzhpszpd
卿=pzpzhhzdzs
郬=hhshszhhzs
圊=szhhshszhhh
清=ddhhhshszhh
蜻=szhshdhhshszhh
鲭=pzszhshhhhshszhh
勍=dhszhspdzp
情=ddshhshszhh
晴=szhhhhshszhh
氰=phhzhhshszhh
暒=szhhszhhphhsh
擎=hsspzszhphpdphhs
檠=hsspzszhphpdhspd
黥=szdphshhdddddhszhspd
苘=hssszszh
顷=hzhpszpd
请=dzhhshszhh
庼=dhphzhpszpd
庆=dhphpd
碃=hpszhhhshszhh
箐=phdphdhhshszhh
靘=hhshszhhpzzshz
磬=hshzshppzzdhpszh
罄=hshzshppzzdphhszs
芎=hsszhz
邛=hshzs
穷=ddzpdzp
穹=ddzpdzhz
茕=hssdzzhs
筇=phdphdhshzs
琼=hhshdhszhspd
蛩=hshpzdszhshd
跫=hshpzdszhshpd
銎=hshpzdpdhhsdph
丘=pshsh
邱=pshshzs
秋=phspddppd
蚯=szhshdpshsh
萩=hssphspddppd
楸=hspdphspddppd
鹙=phspddppdpzdzh
鳅=pzszhshhphspddppd
鞧=hsshszhhsdphszpzhh
囚=szpdh
犰=pzppz
求=hsdhpdd
虬=szhshdz
泅=ddhszpdh
俅=pshsdhpdd
訄=pzdhhhszh
酋=dphszpzhh
逑=hsdhpdddzd
球=hhshhsdhpdd
赇=szpdhsdhpdd
巯=zdhshdhzdpsz
遒=dphszpzhhdzd
裘=hsdhpdddhpzpd
璆=hhshzdhzdhpdppp
蝤=szhshddphszpzhh
鼽=pszhhhszhshhpspz
糗=dphspdpszhhhhpdd
区=hpdz
曲=szhssh
岖=szshpdz
诎=dzzsszs
驱=zzhhpdz
坥=hshszhhh
屈=zhpzsszs
岨=szsszhhh
祛=dzsdhshzd
胠=pzhhhshzd
袪=dzspdhshzd
蛆=szhshdszhhh
躯=pszhhhphpdz
蛐=szhshdszhssh
趋=hshshpdpzzhh
麹=hhshpzdpzdphspd
黢=szdphshhddddzdpdpzd
佢=pshzhz
劬=pzszhzp
朐=pzhhpzszh
鸲=pzszhpzdzh
渠=ddhhzhzhspd
蕖=hssddhhzhzhspd
磲=hpszhddhhzhzhspd
璩=hhshshzphzhpzpppd
瞿=szhhhszhhhpsdhhhsh
鼩=pshzhhzddzddzpzszh
蘧=hssshzphzhpzpppddzd
灈=ddhszhhhszhhhpsdhhhsh
氍=szhhhszhhhpsdhhhshphhz
癯=dhpdhszhhhszhhhpsdhhhsh
衢=ppsszhhhszhhhpsdhhhshhhs
蠼=szhshdszhhhszhhhpsdhhhshzd
取=hsshhhzd
竘=dhdphpzszh
娶=hsshhhzdzph
龋=shshpdzspszhszshd
去=hshzd
阒=dszszhhhhpdd
觑=shzphzssdphszpz
趣=hshshpdhsshhhzd
悛=ddszdpdpzd
圈=szdphhpdzzh
棬=hspddphhpdzz
全=pdhhsh
权=hspdzd
佺=pspdhhsh
诠=dzpdhhsh
泉=pszhhszpd
荃=hsspdhhsh
拳=dphhpdphhs
辁=hzshpdhhsh
婘=zphdphhpdzz
痊=dhpdhpdhhsh
铨=phhhzpdhhsh
筌=phdphdpdhhsh
瑔=hhshpszhhszpd
蜷=szhshddphhpdzz
醛=hszpzhhhsspdhhsh
鳈=pzszhshhpszhhszpd
鬈=hshhhzdpppdphhpdzz
颧=hssszhszhpsdhhhshhpszpd
犬=hpdd
畎=szhshhpdd
绻=zzhdphhpdzz
劝=zdzp
券=dphhpdzp
缺=phhszszhpd
阙=dszdphzsppzpd
瘸=dhpdhzpszhszpdpd
却=hshzdzs
埆=hshpzpzhhs
悫=hshdzpzdzdd
雀=spdpsdhhhsh
确=hpszhpzpzhhs
阕=dszzdppdhhpd
碏=hpszhhsshszhh
鹊=hsshszhhpzdzh
榷=hspddzpsdhhhsh
囷=szphspdh
逡=zdpdpzddzd
裙=dzspdzhhpszh
群=zhhpszhdphhhs
蚺=szhshdszshh
然=pzddhpdddddd
髯=hshhhzdpppszshh
燃=dppdpzddhpdddddd
冉=szshh
苒=hssszshh
染=ddhpzhspd
珃=hhshszshh
儴=psdhszhszhhhsshpzpd
瀼=ddhdhszhszhhhsshpzpd
蘘=hssdhszhszhhhsshpzpd
禳=dzsddhszhszhhhsshpzpd
瓤=dhszhszhhhsshpzpdppzdd
穰=phspddhszhszhhhsshpzpd
嚷=szhdhszhszhhhsshpzpd
壤=hshdhszhszhhhsshpzpd
攘=hshdhszhszhhhsshpzpd
让=dzshh
娆=zphhzphpz
荛=hsshzphpz
饶=pzzhzphpz
桡=hspdhzphpz
扰=hshhpzd
绕=zzhhzphpz
惹=hsshpszhdzdd
热=hshpzddddd
人=pd
仁=pshh
壬=phsh
忍=zpddzdd
荏=hsspsphsh
稔=phspdpddzdzdd
刃=zpd
认=dzpd
仞=pszpd
讱=dzzpd
任=psphsh
纫=zzhzpd
妊=zphphsh
纴=zzhphsh
轫=hzshzpd
韧=hhzszpd
饪=pzzphsh
衽=dzspdphsh
葚=hsshsshhhpdz
扔=hshzp
仍=pszp
礽=dzsdzp
日=szhh
驲=zzhszhh
茸=hsshsshhh
戎=hhpzpd
狨=pzphhpzpd
绒=zzhhhpzpd
荣=hssdzhspd
容=ddzpdpdszh
嵘=szshssdzhspd
溶=ddhddzpdpdszh
蓉=hssddzpdpdszh
榕=hspdddzpdpdszh
熔=dppdddzpdpdszh
瑢=hhshddzpdpdszh
蝾=szhshdhssdzhspd
镕=phhhzddzpdpdszh
融=hszhszdphsszhshd
冗=dzpz
柔=zdzsphspd
揉=hshzdzsphspd
糅=dphspdzdzsphspd
蹂=szhshshzdzsphspd
鞣=hsshszhhszdzsphspd
肉=szpdpd
如=zphszh
茹=hsszphszh
铷=phhhzzphszh
儒=pshdzsddddhpszss
嚅=szhhdzsddddhpszss
嬬=zphhdzsddddhpszss
孺=zshhdzsddddhpszss
濡=ddhhdzsddddhpszss
薷=hsshdzsddddhpszss
襦=dzspdhdzsddddhpszss
蠕=szhshdhdzsddddhpszss
颥=hdzsddddhpszsshpszpd
汝=ddhzph
乳=pddpzshz
辱=hphhzpdhsd
入=pd
洳=ddhzphszh
溽=ddhhphhzpdhsd
缛=zzhhphhzpdhsd
蓐=hsshphhzdphsd
褥=dzspdhphhzpdhsd
挼=hshpddpzph
堧=hshhpszsshpd
阮=zshhpz
朊=pzhhhhpz
软=hzshpzpd
媆=zphhpszsshpd
瓀=hhshhdzsddddhpszss
蕤=hsshpzpppdphhsh
蕊=hssdzdddzdddzdd
汭=ddhszpd
芮=hssszpd
枘=hspdszpd
蚋=szhshdszpd
锐=phhhzdpszhpz
瑞=hhshszshpszss
睿=shdzhpdpdszhhh
闰=dszhhsh
润=ddhdszhhsh
叒=zdzdzd
若=hsshpszh
偌=pshsshpszh
弱=zhzdhzhzdh
鄀=hsshpszhzs
蒻=hsszhzdhzhzdh
箬=phdphdhsshpszh
爇=hsshshpdhshpzddddd
仨=pshhh
挲=ddhspdpphhs
撒=hshhsshszhhphpd
洒=ddhhszpzh
靸=hsshszhhspzd
潵=ddhhsshszhhphpd
卅=hpss
飒=dhdphpzpd
脎=pzhhpdhspd
萨=hsszsdhdphp
塞=ddzhhsshpdhsh
腮=pzhhszhshdzdd
嘥=szhppsshshshpd
噻=szhddzhhsshpdhsh
鳃=pzszhshhszhshdzdd
嗮=szhszhhhszpzh
赛=ddzhhsshpdszpd
三=hhh
叁=zdhpdhhh
毵=zdhpdpppphhz
伞=pddphs
糁=dphspdzdhpdppp
馓=pzzhsshszhhphpd
散=hsshszhhphpd
桑=zdzdzdhspd
嗓=szhzdzdzdhspd
搡=hshzdzdzdhspd
磉=hpszhzdzdzdhspd
颡=zdzdzdhspdhpszpd
丧=hsdphzpd
搔=hshzddszhshd
溞=ddhzddszhshd
骚=zzhzddszhshd
缫=zzhzzzszhhhspd
臊=pzhhszhszhszhhspd
扫=hshzhh
嫂=zphpshzhhszd
埽=hshzhhdzszs
瘙=dhpdhzddszhshd
色=pzzshz
洓=ddhhszspd
涩=ddhzpdshsh
啬=hsdphszszhh
铯=phhhzpzzshz
瑟=hhshhhshdzdpd
穑=phspdhsdphszszhh
璱=hhshhhshhhshdzdpd
森=hspdhspdhspd
僧=psdpszsdphszhh
杀=pdhspd
沙=ddhspdp
纱=zzhspdp
刹=pdhspdss
砂=hpszhspdp
莎=hssddhspdp
铩=phhhzpdhspd
痧=dhpdhddhspdp
煞=pzzhhphpddddd
裟=ddhspdpdhpzpd
鲨=ddhspdppzszhshh
傻=pspszpdhpdpzd
唼=szhdhdphzph
啥=szhpdhhsszh
厦=hphpszhhhpzd
歃=phspshzhhpzpd
霎=hdzsdddddhdphzph
筛=phdphdsphszs
酾=hszpzhhhszdszd
晒=szhhhszpzh
山=szs
删=pzpzhss
杉=hspdppp
芟=hsspzzd
姗=zphpzpzh
苫=hssshszh
衫=dzspdppp
钐=phhhzppp
埏=hshpshzzd
珊=hhshpzpzh
舢=ppzdhdszh
跚=szhshshpzpzh
煽=dppddzhpzdhzdh
潸=ddhhspdhspdszhh
膻=pzhhdhszszhhszhhh
闪=dszpd
陕=zshdphpd
晱=szhhdppddppd
讪=dzszs
汕=ddhszs
疝=dhpdhszs
剡=dppddppdss
扇=dzhpzdhzdh
掞=hshdppddppd
善=dphhhsdphszh
骟=zzhdzhpzdhzdh
鄯=dphhhsdphszhzs
墡=hshdphhhsdphszh
缮=zzhdphhhsdphszh
嬗=zphdhszszhhszhhh
擅=hshdhszszhhszhhh
膳=pzhhdphhhsdphszh
赡=szpdpzhppddhhhszh
蟮=szhshddphhhsdphszh
鳝=pzszhshhdphhhsdphszh
伤=psphzp
殇=hpzdphzpp
商=dhdpszpdszh
觞=pzpzhhsphzpp
墒=hshdhdpszpdszh
熵=dppddhdpszpdszh
垧=hshpszszh
晌=szhhpszszh
赏=sdpdzszhszpd
上=shh
尚=sdpszszh
恦=ddspszszh
绱=zzhsdpszszh
裳=sdpdzszhdhpzpd
捎=hshsdpszhh
烧=dppdhzphpz
梢=hspdsdpszhh
稍=phspdsdpszhh
筲=phdphdsdpszhh
艄=ppzdhdsdpszhh
蛸=szhshdsdpszhh
勺=pzd
芍=hsspzd
苕=hsszpszh
柖=hspdzpszh
玿=hhshzpszh
韶=dhdphszhhzpszh
少=spdp
劭=zpszhzp
邵=zpszhzs
绍=zzhzpszh
哨=szhsdpszhh
睄=szhhhsdpszhh
潲=ddhphspdsdpszhh
奢=hpdhshpszhh
猞=pzppdhhsszh
赊=szpdpdhhspd
畬=pdhhspdszhsh
畲=pdhhspdszhsh
舌=phsszh
佘=pdhhspd
蛇=szhshdddzpz
舍=pdhhsszh
厍=hphzhs
设=dzpzzd
社=dzsdhsh
射=pszhhhphsd
涉=ddhshshspp
赦=hshpspdphpd
慑=ddshsshhhzdzd
摄=hshhsshhhzdzd
滠=ddhhsshhhzdzd
歙=pdhszhzdhzdhpzpd
麝=dhpzsshhzpzpszhhhphsd
谁=dzpsdhhhsh
申=szhhs
屾=szsszs
伸=psszhhs
身=pszhhhp
侁=psphshpz
呻=szhszhhs
绅=zzhszhhs
诜=dzphshpz
珅=hhshszhhs
娠=zphhphhzpd
甡=phhshphhsh
砷=hpszhszhhs
莘=hssdhdphhs
深=ddhdzpdhspd
棽=hspdhspdpddz
燊=dppddppddppdhspd
鲹=pzszhshhzdhpdppp
什=pshs
甚=hsshhhpdz
神=dzsdszhhs
沈=ddhdzpz
审=ddzszhhs
哂=szhhszpzh
矧=phhpdzhzs
谂=dzpddzdzdd
婶=zphddzszhhs
瞫=szhhhhszsshszhhhs
肾=sszdszhh
胂=pzhhszhhs
渗=ddhzdhpdppp
慎=ddshsszhhhhpd
椹=hspdhsshhhpdz
瘆=dhpdhzdhpdppp
蜃=hphhzpdszhshd
升=phps
生=phhsh
声=hshzshp
昇=szhhphps
牲=phshphhsh
珄=hhshphhsh
陞=zsphpshsh
笙=phdphdphhsh
湦=ddhszhhphhsh
焺=dppdszhhphps
甥=phhshszhshzp
绳=zzhszhszhhz
省=spdpszhhh
眚=phhshszhhh
圣=zdhsh
胜=pzhhphhsh
盛=hpzzpdszssh
剩=phsshhpzpdss
嵊=szsphsshhpzpd
琞=szhhpzhhhhshd
尸=zhp
失=phhpd
师=sphszs
虱=zpszhshd
诗=dzhshhsd
邿=hshhsdzs
鸤=zhppzdzh
施=dhzpphzsz
浉=ddhsphszs
狮=pzpsphszs
湿=ddhszhhssdph
蓍=hsshshppzszhh
鲺=pzszhshhzpszhshd
十=hs
石=hpszh
时=szhhhsd
识=dzszhpd
实=ddzddhpd
実=ddzhhhpd
拾=hshpdhszh
炻=dppdhpszh
祏=dzsdhpszh
蚀=pzzszhshd
食=pddzhhzpd
埘=hshszhhhsd
莳=hssszhhhsd
湜=ddhszhhhshpd
鲥=pzszhshhszhhhsd
鼫=pshzhhzddzddzhpszh
史=szhpd
矢=phhpd
豕=hpzpppd
使=pshszhpd
始=zphzdszh
驶=zzhszhpd
屎=zhpdphspd
士=hsh
氏=pzhz
世=hsshz
仕=pshsh
市=dhszs
示=hhspd
似=pszdpd
式=hhshzd
事=hszhzhhs
侍=pshshhsd
势=hshpzdzp
视=dzsdszpz
试=dzhhshzd
饰=pzzphszs
室=ddzhzdhsh
恃=ddshshhsd
拭=hshhhshzd
是=szhhhshpd
昰=szhhhshsh
柿=hspddhszs
贳=hsshzszpd
适=phsszhdzd
栻=hspdhhshzd
舐=phsszhpzhz
轼=hzshhhshzd
逝=hshpphsdzd
铈=phhhzdhszs
豉=hszhdphhszd
媞=zphszhhhshpd
弑=pdhspdhhshzd
谥=dzdphpdszssh
释=pdphspdzdhhs
嗜=szhhshppzszhh
筮=phdphdhspdpdh
誓=hshpphsdhhhszh
奭=hhpszhhhpszhhpd
噬=szhphdphdhspdpdh
螫=hshpspdphpdszhshd
襫=dzspdhhpszhhhpszhhpd
匙=szhhhshpdpz
收=zsphpd
手=phhs
守=ddzhsd
首=dphpszhhh
艏=ppzdhddphpszhhh
寿=hhhphsd
受=pddpdzzd
狩=pzpddzhsd
兽=dpszhshhszh
售=psdhhhshszh
授=hshpddpdzzd
绶=zzhpddpdzzd
瘦=dhpdhpshzhhszd
书=zzsd
殳=pzzd
抒=hshzdzs
纾=zzhzdzs
叔=shhspdzd
枢=hspdhpdz
陎=zsphhspd
姝=zphphhspd
倏=psspzdhpdd
殊=hpzdphhspd
梳=hspddhzdpsz
淑=ddhshhspdzd
菽=hssshhspdzd
鄃=pdhszhhsszs
疏=zshshdhzdpsz
舒=pdhhsszhzdzs
摅=hshshzphzdzdd
毹=pdhszhhssphhz
输=hzshpdhszhhss
蔬=hsszshshdhzdpsz
秫=phspdhspdd
婌=zphshhspdzd
孰=dhszhzshpzd
赎=szpdhszddhpd
塾=dhszhzshpzdhsh
熟=dhszhzshpzddddd
属=zhppszhszshd
暑=szhhhshpszhh
黍=phspdpdsdhpd
署=szsshhshpszhh
蜀=szsshpzszhshd
鼠=pshzhhzddzddz
薯=hssszsshhshpszhh
曙=szhhszsshhshpszhh
术=hspdd
戍=hpdzpd
束=hszhspd
沭=ddhhspdd
述=hspdddzd
树=hspdzdhsd
竖=sszddhdph
恕=zphszhdzdd
庶=dhphsshdddd
隃=zspdhszhhss
数=dphspdzphphpd
腧=pzhhpdhszhhss
墅=szhhshhzdzshsh
漱=ddhhszhspdpzpd
澍=ddhhshszhdphhsd
刷=zhpszsss
唰=szhzhpszsss
耍=hpszsszph
衰=dhszhhpzpd
摔=hshdhzzddhpdhs
甩=pzhhz
帅=spszs
蟀=szhshddhzzddhpdhs
闩=dszh
拴=hshpdhhsh
栓=hspdpdhhsh
涮=ddhzhpszsss
腨=pzhhszshpszss
双=zdzd
霜=hdzsddddhspdszhhh
孀=zphhdzsddddhspdszhhh
骦=zzhhdzsddddhspdszhhh
礵=hpszhhdzsddddhspdszhhh
鹴=hdzsddddhspdszhhhpzdzh
爽=hpdpdpdpdpd
灀=ddhhdzsddddhspdszhhh
水=szpd
帨=szsdpszhpz
税=phspddpszhpz
睡=szhhhphshsshh
瞓=szhhhdhhhszhpss
吮=szhzdpz
顺=psshpszpd
舜=pddpdzpzdhzs
瞬=szhhhpddpdzpzdhzs
说=dzdpszhpz
妁=zphpzd
烁=dppdpzspd
朔=dphzsppzhh
铄=phhhzpzspd
硕=hpszhhpszpd
搠=hshdphzsppzhh
蒴=hssdphzsppzhh
槊=dphzsppzhhhspd
丝=zzzzh
司=zhszh
私=phspdzd
咝=szhzzzzh
思=szhshdzdd
虒=ppshzphzpz
鸶=zzzzhpzdzh
斯=hsshhhpdpphs
缌=zzhszhshdzdd
蛳=szhshdsphszs
楒=hspdszhshdzdd
飔=pzpdszhshdzdd
凘=dhhsshhhpdpphs
厮=hphsshhhpdpphs
锶=phhhzszhshdzdd
嘶=szhhsshhhpdpphs
撕=hshhsshhhpdpphs
澌=ddhhsshhhpdpphs
死=hpzdpz
巳=zhz
亖=hhhh
四=szpzh
寺=hshhsd
汜=ddhzhz
兕=szszhpz
姒=zphzdpd
祀=dzsdzhz
泗=ddhszpzh
饲=pzzzhszh
驷=zzhszpzh
涘=ddhzdphhpd
笥=phdphdzhszh
耜=hhhspdszhzh
嗣=szhszhsszhszh
肆=hshhhzdzhhhhs
忪=ddspdzd
松=hspdpdzd
娀=zphhhpzpd
凇=dhhspdpdzd
崧=szshspdpdzd
淞=ddhhspdpdzd
菘=hsshspdpdzd
嵩=szsdhszhszszh
怂=pdpddzdd
悚=ddshszhspd
耸=pdpdhsshhh
竦=dhdphhszhspd
讼=dzpdzd
宋=ddzhspd
诵=dzzdszhhs
送=dphhpddzd
颂=pdzdhpszpd
嗖=szhpshzhhszd
廋=dhppshzhhszd
搜=hshpshzhhszd
溲=ddhpshzhhszd
蒐=hsspszhhpzzd
馊=pzzpshzhhszd
飕=pzpdpshzhhszd
锼=phhhzpshzhhszd
艘=ppzdhdpshzhhszd
螋=szhshdpshzhhszd
叟=pshzhhszd
嗾=szhdhzpphphhpd
瞍=szhhhpshzhhszd
擞=hshdphspdzphphpd
薮=hssdphspdzphphpd
嗽=szhhszhspdpzpd
苏=hsszpdd
甦=hszhhpdphhsh
酥=hszpzhhphspd
稣=pzszhshhphspd
窣=ddzpddhpdpdhs
俗=pspdpdszh
玊=hhshd
夙=pzhpzd
诉=dzpphsd
肃=zhhspspd
涑=ddhhszhspd
素=hhshzzdspd
速=hszhspddzd
宿=ddzpshpszhh
骕=zzhzhhspspd
傃=pshhshzzdspd
粟=hszsshdphspd
谡=dzszhshpdpzd
嗉=szhhhshzzdspd
塑=dphzsppzhhhsh
愫=ddshhshzzdspd
溯=ddhdphzsppzhh
鹔=zhhspspdpzdzh
僳=pshszsshdphspd
蔌=hsshszhspdpzpd
觫=pzpzhhshszhspd
簌=phdphdhszhspdpzpd
蹜=szhshshddzpshpszhh
狻=pzpzdpdpzd
酸=hszpzhhzdpdpzd
蒜=hsshhspdhhspd
算=phdphdszhhhhps
虽=szhszhshd
荽=hsspddpzph
眭=szhhhhshhsh
葰=hsspszdpdpzd
睢=szhhhpsdhhhsh
濉=ddhszhhhpsdhhhsh
绥=zzhpddpzph
隋=zshphshszhh
随=zshpszhhdzd
髓=szzdzszhhhphshszhhdzd
岁=szspzd
祟=zsszshhspd
谇=dzdhpdpdhs
遂=dphpzpppddzd
碎=hpszhdhpdpdhs
隧=zsdphpzpppddzd
燧=dppddphpzpppddzd
璲=hhshdphpzpppddzd
穗=phspdhszhhshddzdd
穟=phspddphpzpppddzd
襚=dzspddphpzpppddzd
邃=ddzpddphpzpppddzd
旞=dhzpphdphpzpppddzd
孙=zshspd
狲=pzpzshspd
荪=hsszshspd
飧=pzdpddzhhzpd
损=hshszhszpd
笋=phdphdzhhp
隼=psdhhhshhs
榫=hspdpsdhhhshhs
唆=szhzdpdpzd
娑=ddhspdpzph
桫=hspdddhspdp
梭=hspdzdpdpzd
睃=szhhhzdpdpzd
嗍=szhdphzsppzhh
羧=dphhhpzdpdpzd
蓑=hssdhszhhpzpd
缩=zzhddzpshpszhh
所=ppzhpphs
唢=szhsdpszpd
索=hsdzzzdspd
琐=hhshsdpszpd
锁=phhhzsdpszpd
溹=ddhhsdzzzdspd
嗦=szhhsdzzzdspd
他=pszsz
它=ddzpz
她=zphzsz
祂=dzsdzsz
趿=szhshshpzd
铊=phhhzddzpz
塌=hshszhhzdhzdh
溻=ddhszhhzdhzdh
褟=dzspdszhhzdhzdh
塔=hshhsspdhszh
溚=ddhhsspdhszh
獭=pzphszhspdpzszpd
鳎=pzszhshhszhhzdhzdh
拓=hshhpszh
挞=hshhpddzd
闼=dszhpddzd
遢=szhhzdhzdhdzd
榻=hspdszhhzdhzdh
踏=szhshshszpdszhh
蹋=szhshshszhhzdhzdh
鞳=hsshszhhshsspdhszh
胎=pzhhzdszh
台=zdszh
邰=zdszhzs
抬=hshzdszh
苔=hsszdszh
炱=zdszhdppd
跆=szhshshzdszh
鲐=pzszhshhzdszh
薹=hsshshszhdzhzdhsh
太=hpdd
汰=ddhhpdd
态=hpdddzdd
肽=pzhhhpdd
钛=phhhzhpdd
泰=hhhpdsdhpd
酞=hszpzhhhpdd
坍=hshpzdh
贪=pddzszpd
摊=hshzdpsdhhhsh
滩=ddhzdpsdhhhsh
瘫=dhpdhzdpsdhhhsh
坛=hshhhzd
昙=szhhhhzd
倓=psdppddppd
谈=dzdppddppd
郯=dppddppdzs
惔=ddsdppddppd
覃=hszsshszhhhs
榃=hspdhspdszhsh
痰=dhpdhdppddppd
锬=phhhzdppddppd
谭=dzhszsshszhhhs
潭=ddhhszsshszhhhs
檀=hspddhszszhhszhhh
磹=hpszhhszsshszhhhs
忐=shhdzdd
坦=hshszhhh
袒=dzspdszhhh
钽=phhhzszhhh
菼=hssdppddppd
毯=phhzdppddppd
璮=hhshdhszszhhszhhh
叹=szhzd
炭=szshpdppd
探=hshdzpdhspd
碳=hpszhszshpdppd
汤=ddhzpp
铴=phhhzddhzpp
嘡=szhsdpdzszhhsh
耥=hhhspdsdpszszh
劏=sdpdzszhszhshss
羰=dphhhpszshpdppd
镗=phhhzsdpdzszhhsh
蹚=szhshshsdpdzszhhsh
饧=pzzzpp
唐=dhpzhhsszh
堂=sdpdzszhhsh
棠=sdpdzszhhspd
鄌=dhpzhhsszhzs
塘=hshdhpzhhsszh
搪=hshdhpzhhsszh
溏=ddhdhpzhhsszh
瑭=hhshdhpzhhsszh
樘=hspdsdpdzszhhsh
膛=pzhhsdpdzszhhsh
糖=dphspddhpzhhsszh
螗=szhshddhpzhhsszh
螳=szhshdsdpdzszhhsh
帑=zphzdszs
倘=pssdpszszh
淌=ddhsdpszszh
傥=pssdpdzszhpz
躺=pszhhhpsdpszszh
镋=phhhzsdpdzszhpz
烫=ddhzppdppd
趟=hshshpdsdpszszh
弢=zhzzsszd
涛=ddhhhhphsd
绦=zzhpzdhspd
掏=hshpzphhszs
慆=ddspddppshzhh
滔=ddhpddppshzhh
韬=hhzspddppshzhh
饕=szhhzshzphzpzpddzhhzpd
洮=ddhpdhzpd
逃=pdhzpddzd
桃=hspdpdhzpd
陶=zspzphhszs
啕=szhpzphhszs
梼=hspdhhhphsd
淘=ddhpzphhszs
绹=zzhpzphhszs
萄=hsspzphhszs
鼗=pdhzpdhshszhdphhszd
讨=dzhsd
套=hpdhshhhzd
忑=hsddzdd
忒=hdzddzd
特=phshhshhsd
铽=phhhzhdzddzd
慝=hhsshpszhzdzdd
螣=pzhhdphhpdszhshd
熥=dppdzdszhhsdzd
疼=dhpdhpzddd
腾=pzhhdphhpdzzh
誊=dphhpddhhhszh
滕=pzhhdphhpdsdhpd
縢=pzhhdphhpdzzdspd
藤=hsspzhhdphhpdsdhpd
剔=szhhpzppss
梯=hspddpzhzsp
锑=phhhzdpzhzsp
踢=szhshshszhhpzpp
擿=hshdhdpszhsszhdzd
荑=hsshzhzpd
绨=zzhdpzhzsp
啼=szhdhdpdzszs
提=hshszhhhshpd
缇=zzhszhhhshpd
遆=dhdpdzszsdzd
鹈=dpzhzsppzdzh
瑅=hhshszhhhshpd
题=szhhhshpdhpszpd
蹄=szhshshdhdpdzszs
醍=hszpzhhszhhhshpd
鳀=pzszhshhszhhhshpd
体=pshspdh
屉=zhphsshz
剃=dpzhzspss
倜=pspzhshszh
悌=ddsdpzhzsp
涕=ddhdpzhzsp
逖=pzpdppddzd
惕=ddsszhhpzpp
替=hhpdhhpdszhh
裼=dzspdszhhpzpp
薙=hssphhpdpsdhhhsh
嚏=szhhsdzszhshzshsd
趯=hshshpdzdhzdhpsdhhhsh
天=hhpd
兲=hhshpd
添=ddhhhpdsddd
黇=hsshszhshpdshszh
田=szhsh
沺=ddhszhsh
恬=ddsphsszh
畋=szhshphpd
畑=dppdszhsh
盷=szhhhpzdh
甜=phsszhhsshh
湉=ddhddsphsszh
填=hshhsszhhhhpd
阗=dszhsszhhhhpd
忝=hhpdsddd
殄=hpzdpdppp
淟=ddhszhsshpd
晪=szhhszhsshpd
腆=pzhhszhsshpd
舔=phsszhhhpdsddd
掭=hshhhpdsddd
佻=pspdhzpd
挑=hshpdhzpd
祧=dzsdpdhzpd
条=pzdhspd
迢=zpszhdzd
笤=phdphdzpszh
龆=shshpdzszpszh
蜩=szhshdpzhshszh
髫=hshhhzdpppzpszh
鲦=pzszhshhpzdhspd
朓=pzhhpdhzpd
窕=ddzpdpdhzpd
嬥=zphzdhzdhpsdhhhsh
眺=szhhhpdhzpd
粜=zsszsdphspd
跳=szhshshpdhzpd
帖=szsshszh
贴=szpdshszh
萜=hssszsshszh
铁=phhhzphhpd
餮=hpzdpdppppddzhhzpd
厅=hphs
汀=ddhhs
听=szhpphs
町=szhshhs
烃=dppdzdhsh
桯=hspdszhhhsh
廷=phshzd
亭=dhszhdzhs
庭=dhpphshzd
莛=hssphshzd
停=psdhszhdzhs
婷=zphdhszhdzhs
渟=ddhdhszhdzhs
葶=hssdhszhdzhs
蜓=szhshdphshzd
霆=hdzsddddphshzd
圢=hshhs
侹=psphshzd
挺=hshphshzd
梃=hspdphshzd
烶=dppdphshzd
珽=hhshphshzd
艇=ppzdhdphshzd
颋=phshzdhpszpd
通=zdszhhsdzd
嗵=szhzdszhhsdzd
仝=pdhsh
同=szhszh
佟=pspzddd
彤=pzdhppp
峂=szspzddd
哃=szhszhszh
茼=hssszhszh
桐=hspdszhszh
烔=dppdszhszh
砼=hpszhpdhsh
铜=phhhzszhszh
童=dhdphszhhshh
酮=hszpzhhszhszh
僮=psdhdphszhhshh
鲖=pzszhshhszhszh
潼=ddhdhdphszhhshh
曈=szhhdhdphszhhshh
橦=hspddhdphszhhshh
瞳=szhhhdhdphszhhshh
统=zzhdhzdpz
捅=hshzdszhhs
桶=hspdzdszhhs
筒=phdphdszhszh
恸=ddshhzdzp
痛=dhpdhzdszhhs
偷=pspdhszhhss
头=ddhpd
投=hshpzzd
骰=szzdzszhhpzzd
钭=phhhzddhs
透=phspdzpdzd
凸=shszh
秃=phspdpz
突=ddzpdhpdd
葖=hssddzpdhpdd
图=szpzdddh
徒=ppshshshpd
涂=ddhpdhhspd
荼=hsspdhhspd
途=pdhhspddzd
屠=zhphshpszhh
梌=hspdpdhhspd
菟=hsspzszhpzd
稌=phspdpdhhspd
腯=pzhhpphsszhhh
酴=hszpzhhpdhhspd
土=hsh
吐=szhhsh
钍=phhhzhsh
兔=pzszhpzd
堍=hshpzszhpzd
湍=ddhszshpszss
猯=pzpszshpszss
煓=dppdszshpszss
团=szhsph
抟=hshhhzd
疃=szhshdhdphszhhshh
彖=zzhpzpppd
推=hshpsdhhhsh
颓=phspdpzhpszpd
魋=pszhhpzzdpsdhhhsh
腿=pzhhzhhzpddzd
退=zhhzpddzd
煺=dppdzhhzpddzd
蜕=szhshddpszhpz
褪=dzspdzhhzpddzd
吞=hhpdszh
焞=dppddhszhzsh
暾=szhhdhszhzshphpd
屯=hzsz
坉=hshhzsz
忳=ddshzsz
饨=pzzhzsz
豚=pzhhhpzpppd
鲀=pzszhshhhzsz
臀=zhphsshpdpzzdszhh
托=hshphz
侂=psdhpphz
拖=hshphzsz
脱=pzhhdpszhpz
驮=zzhhpd
佗=psddzpz
陀=zsddzpz
坨=hshddzpz
沱=ddhddzpz
驼=zzhddzpz
砣=hpszhddzpz
鸵=pzdzhddzpz
跎=szhshshddzpz
酡=hszpzhhddzpz
橐=hszhsdzhpszhhspd
鼍=szhszhszhshhszhszhhz
妥=pddpzph
庹=dhphsshzhpd
椭=hspdzshpszhh
柝=hspdpphsd
唾=szhphshsshh
萚=hsshshzdhhs
箨=phdphdhshzdhhs
挖=hshddzpdz
洼=ddhhshhsh
娲=zphszhszpd
畖=szhshppzdd
窊=ddzpdppzdd
蛙=szhshdhshhsh
娃=zphhshhsh
瓦=hzzd
佤=pshzzd
袜=dzspdhhspd
腽=pzhhszhhszssh
哇=szhhshhsh
歪=hpsdhshsh
崴=szshphzphzpd
外=pzdsd
弯=dhsspdzhz
剜=ddzpzdzzss
婠=zphddzszhzh
塆=hshdhsspdzhz
湾=ddhdhsspdzhz
蜿=szhshdddzpzdzz
豌=hszhdphddzpzdzz
丸=pzd
纨=zzhpzd
芄=hsspzd
完=ddzhhpz
玩=hhshhhpz
顽=hhpzhpszpd
烷=dppdddzhhpz
宛=ddzpzdzz
挽=hshpzszhpz
婉=zphddzpzdzz
惋=ddsddzpzdzz
晚=szhhpzszhpz
绾=zzhddzszhzh
脘=pzhhddzhhpz
菀=hssddzpzdzz
椀=hspdddzpzdzz
琬=hhshddzpzdzz
皖=pszhhddzhhpz
畹=szhshddzpzdzz
碗=hpszhddzpzdzz
万=hzp
妧=zphhhpz
腕=pzhhddzpzdzz
尪=hpzhhsh
汪=ddhhhsh
亡=dhz
王=hhsh
网=szpdpd
往=ppsdhhsh
枉=hspdhhsh
罔=szdphdhz
惘=ddsszdphdhz
辋=hzshszdphdhz
魍=pszhhpzzdszdphdhz
妄=dhzzph
忘=dhzdzdd
旺=szhhhhsh
望=dhzpzhhhhsh
危=pzhpzz
威=hphzphzpd
烓=dppdhshhsh
偎=psszhshhzpd
萎=hssphspdzph
逶=phspdzphdzd
隈=zsszhshhzpd
葳=hsshphzphzpd
微=ppsszshpzphpd
溦=ddhszshpzphpd
煨=dppdszhshhzpd
薇=hssppsszshpzphpd
鳂=pzszhshhszhshhzpd
巍=szsphspdzphpszhhpzzd
韦=hhzs
圩=hshhhs
围=szhhzsh
帏=szshhzs
沩=ddhdpzd
违=hhzsdzd
闱=dszhhzs
峗=szspzhpzz
洈=ddhpzhpzz
桅=hspdpzhpzz
涠=ddhszhhzsh
唯=szhpsdhhhsh
帷=szspsdhhhsh
惟=ddspsdhhhsh
硙=hpszhszszhz
维=zzhpsdhhhsh
嵬=szspszhhpzzd
琟=hhshpsdhhhsh
潍=ddhzzhpsdhhhsh
伟=pshhzs
伪=psdpzd
尾=zhpphhz
纬=zzhhhzs
苇=hsshhzs
委=phspdzph
炜=dppdhhzs
玮=hhshhhzs
洧=ddhhpszhh
娓=zphzhpphhz
诿=dzphspdzph
硊=hpszhpzhpzz
猥=pzpszhshhzpd
痿=dhpdhphspdzph
艉=ppzdhdzhpphhz
韪=szhhhshpdhhzs
鲔=pzszhshhhpszhh
薳=hsshshszhpspddzd
卫=zsh
为=dpzd
未=hhspd
位=psdhdph
味=szhhhspd
畏=szhshhzpd
胃=szhshszhh
尉=zhphhspdhsd
谓=dzszhshszhh
喂=szhszhshhzpd
渭=ddhszhshszhh
猬=pzpszhshszhh
煟=dppdszhshszhh
碨=hpszhszhshhzpd
蔚=hsszhphhspdhsd
慰=zhphhspdhsddzdd
螱=zhphhspdhsdszhshd
魏=phspdzphpszhhpzzd
霨=hdzsddddzhphhspdhsd
鳚=pzszhshhzhphhspdhsd
温=ddhszhhszssh
榅=hspdszhhszssh
辒=hzshszhhszssh
瘟=dhpdhszhhszssh
蕰=hssddhszhhszssh
鳁=pzszhshhszhhszssh
文=dhpd
纹=zzhdhpd
芠=hssdhpd
炆=dppddhpd
玟=hhshdhpd
闻=dszhsshhh
蚊=szhshddhpd
阌=dszpddpdzzd
雯=hdzsdddddhpd
刎=pzppss
吻=szhpzpp
紊=dhpdzzdspd
稳=phspdpzzhhdzdd
问=dszszh
汶=ddhdhpd
揾=hshszhhszssh
璺=pshhszhszhzhhdzhhshd
翁=pdzdzdhzdh
嗡=szhpdzdzdhzdh
滃=ddhpdzdzdhzdh
鹟=pdzdzdhzdhpzdzh
蓊=hsspdzdzdhzdh
瓮=pdzdhzzd
蕹=hssdhzzppsdhhhsh
挝=hshhsddzd
倭=psphspdzph
涡=ddhszhszpd
莴=hssszhszpd
窝=ddzpdszhszpd
蜗=szhshdszhszpd
踒=szhshshphspdzph
我=phshzpd
沃=ddhphpd
肟=pzhhhhz
卧=hszhszsd
偓=pszhphzdhsh
涴=ddhddzpzdzz
幄=szszhphzdhsh
握=hshzhphzdhsh
渥=ddhzhphzdhsh
硪=hpszhphshzpd
斡=hsszhhhspdddhs
龌=shshpdzszhphzdhsh
乌=pzzh
圬=hshhhz
污=ddhhhz
邬=pzzhzs
呜=szhpzzh
巫=hspdpdh
屋=zhphzdhsh
洿=ddhhpdhhz
诬=dzhspdpdh
钨=phhhzpzzh
无=hhpz
毋=zzph
吴=szhhhpd
吾=hszhszh
芜=hsshhpz
郚=hszhszhzs
唔=szhhszhszh
浯=ddhhszhszh
梧=hspdhszhszh
珸=hhshhszhszh
铻=phhhzhszhszh
鹀=hspdpdhpzdzh
蜈=szhshdszhhhpd
鼯=pshzhhzddzddzhszhszh
五=hszh
午=phhs
仵=psphhs
伍=pshszh
妩=zphhhpz
庑=dhphhpz
忤=ddsphhs
怃=ddshhpz
旿=szhhphhs
武=hhshshzd
侮=psphzzdhd
捂=hshhszhszh
牾=phshhszhszh
珷=hhshhhshshzd
鹉=hhshshzdpzdzh
舞=phhsssshpzdhzs
兀=hpz
勿=pzpp
务=pzdzp
戊=hpzpd
阢=zshpz
屼=szshpz
坞=hshpzzh
杌=hspdhpz
芴=hsspzpp
迕=phhsdzd
物=phshpzpp
误=dzszhhhpd
悟=ddshszhszh
晤=szhhhszhszh
焐=dppdhszhszh
婺=zdzspphpdzph
痦=dhpdhhszhszh
靰=hsshszhhshpz
骛=zdzspphpdzzh
雾=hdzsddddpzdzp
寤=ddzzshphszhszh
鹜=zdzspphpdpzdzh
鋈=ddhphpdpdhhsdph
夕=pzd
兮=pdhz
吸=szhpzd
汐=ddhpzd
西=hszpzh
希=pdhpszs
昔=hsshszhh
析=hspdpphs
穸=ddzpdpzd
肸=pzhhpdhs
俙=pspdhpszs
恓=ddshszpzh
郗=pdhpszszs
饻=pzzdhpzpd
唏=szhpdhpszs
奚=pddpzzdhpd
息=pszhhhdzdd
浠=ddhpdhpszs
牺=phshhszpzh
悉=pdphspddzdd
惜=ddshsshszhh
晞=szhhpdhpszs
淅=ddhhspdpphs
烯=dppdpdhpszs
硒=hpszhhszpzh
菥=hsshspdpphs
傒=pspddpzzdhpd
晰=szhhhspdpphs
犀=zhpsdhpdphhs
睎=szhhhpdhpszs
稀=phspdpdhpszs
粞=dphspdhszpzh
翕=pdhszhzdhzdh
舾=ppzdhdhszpzh
溪=ddhpddpzzdhpd
皙=hspdpphspszhh
锡=phhhzszhhpzpp
僖=pshshszhdphszh
熄=dppdpszhhhdzdd
熙=hsszhszzhzdddd
蜥=szhshdhspdpphs
豨=hpzpppdpdhpszs
嘻=szhhshszhdphszh
嬉=zphhshszhdphszh
嶲=szspsdhhhshszsz
膝=pzhhhspdpdsdhpd
憙=hshszhdphszhdzdd
樨=hspdzhpsdhpdphhs
熹=hshszhdphszhdddd
熻=dppdpdhszhzdhzdh
窸=ddzpdpdphspddzdd
羲=dphhshphspdhzzpd
螅=szhshdpszhhhdzdd
蟋=szhshdpdphspddzdd
谿=pddpzzdhpdpdpdszh
釐=hhspdphpdhpszhhshh
醯=hszpzhhdhzdpszszssh
巇=szsshzphzhszhdphhzpd
曦=szhhdphhshphspdhzzpd
爔=dppddphhshphspdhzzpd
酅=szspsdhhhshszpdszhzs
鼷=pshzhhzddzddzpsspzzdhpd
觿=pzpzhhsszspsdhhhshszpdszh
习=zdh
席=dhphsshszs
袭=hpzpddhpzpd
觋=hspdpdhszpz
喺=szhpspzzdspd
媳=zphpszhhhdzdd
嶍=szszdhzdhpszhh
隰=zsszhhzzdzzddddd
檄=hspdpszhhdhzpphpd
鳛=pzszhshhzdhzdhpszhh
枲=zdszhhspd
洗=ddhphshpz
玺=pzspdhhshd
徙=ppsshshshpd
铣=phhhzphshpz
喜=hshszhdphszh
葸=hssszhshdzdd
屣=zhpppsshshshpd
蓰=hssppsshshshpd
暿=szhhhshszhdphszh
禧=dzsdhshszhdphszh
卌=hssss
戏=zdhzpd
屃=zhpszpd
系=pzzdspd
饩=pzzphhz
矽=hpszhpzd
细=zzhszhsh
係=pspzzdspd
咥=szhhzdhsh
盻=szhhhpdhz
郤=pdpdszhzs
绤=zzhpdpdszh
阋=dszpshzhhpz
舄=pshzhhpzdddd
隙=zsspdszhhspd
禊=dzsdhhhszphpd
潟=ddhpshzhhpzdddd
嚱=szhshzphzhszhdphhzsp
虾=szhshdhsd
瞎=szhhhddzhhhsszh
匣=hszhhsz
侠=pshdphpd
狎=pzpszhhs
叚=zhshhzhzd
峡=szshdphpd
柙=hspdszhhs
狭=pzphdphpd
硖=hpszhhdphpd
翈=szhhszdhzdh
遐=zhshhzhzddzd
暇=szhhzhshhzhzd
瑕=hhshzhshhzhzd
辖=hzshddzhhhsszh
霞=hdzsddddzhshhzhzd
黠=szdphshhddddhshszh
下=hsd
吓=szhhsd
夏=hpszhhhpzd
罅=phhszsshzphzpdphs
仙=psszs
先=phshpz
纤=zzhphs
忺=ddspzpd
氙=phhzszs
祆=dzsdhhpd
籼=dphspdszs
莶=hsspdhddph
掀=hshpphspzpd
跹=szhshshphsdzd
酰=hszpzhhphshpz
锨=phhhzpphspzpd
鲜=pzszhshhdphhhs
暹=szhhpsdhhhshdzd
伭=psdhzzd
闲=dszhspd
弦=zhzdhzzd
贤=sszdszpd
咸=hphszhzpd
挦=hshzhhhsd
涎=ddhpshzzd
娴=zphdszhspd
舷=ppzdhddhzzd
衔=ppsphhhzhhs
痫=dhpdhdszhspd
鹇=dszhspdpzdzh
嫌=zphdphzhhsspd
冼=dhphshpz
狝=pzppzspd
显=szhhssdph
险=zspdhddph
崄=szspdhddph
猃=pzppdhddph
蚬=szhshdszpz
筅=phdphdphshpz
禒=dzsdzzhpzpppd
跣=szhshshphshpz
藓=hsspzszhshhdphhhs
燹=hpzpppdhpzpppddppd
伣=psszpz
县=szhhhzd
岘=szsszpz
苋=hssszpz
现=hhshszpz
线=zzhhhzpd
限=zszhhzpd
宪=ddzphshpz
陷=zspzpshzhh
硍=hpszhzhhzpd
馅=pzzpzpshzhh
缐=zzhpszhhszpd
羡=dphhshdhpzpd
献=hsszdphhshpdd
腺=pzhhpszhhszpd
霰=hdzsddddhsshszhhphpd
乡=zzp
芗=hsszzp
相=hspdszhhh
香=phspdszhh
厢=hphspdszhhh
湘=ddhhspdszhhh
缃=zzhhspdszhhh
葙=hsshspdszhhh
箱=phdphdhspdszhhh
襄=dhszhszhhhsshpzpd
骧=zzhdhszhszhhhsshpzpd
瓖=hhshdhszhszhhhsshpzpd
镶=phhhzdhszhszhhhsshpzpd
详=dzdphhhs
庠=dhpdphhhs
祥=dzsddphhhs
翔=dphhhpzdhzdh
享=dhszhzsh
响=szhpszszh
饷=pzzpszszh
飨=zzppddzhhzpd
想=hspdszhhhdzdd
鲞=dphhpdpzszhshh
向=pszszh
巷=hsshpdzhz
项=hshhpszpd
珦=hhshpszszh
象=pzszhpzpppd
像=pspzszhpzpppd
橡=hspdpzszhpzpppd
枭=pzdzhspd
哓=szhhzphpz
枵=hspdszhhz
骁=zzhhzphpz
哮=szhhshpzsh
宵=ddzsdpszhh
消=ddhsdpszhh
绡=zzhsdpszhh
虓=pzshzphzpz
逍=sdpszhhdzd
鸮=szhhzpzdzh
婋=zphshzphzpz
猇=pzpshzphzpz
萧=hsszhhspspd
硝=hpszhsdpszhh
翛=psspzdzdhzdh
销=phhhzsdpszhh
潇=ddhhsszhhspspd
箫=phdphdzhhspspd
霄=hdzsddddsdpszhh
魈=pszhhpzzdsdpszhh
蟏=szhshdhsszhhspspd
嚣=szhszhhpszpdszhszh
洨=ddhdhpdpd
崤=szspdhpszhh
淆=ddhpdhpszhh
筊=phdphddhpdpd
小=spd
晓=szhhhzphpz
筱=phdphdpssphpd
皛=pszhhpszhhpszhh
孝=hshpzsh
肖=sdpszhh
咲=szhdphhpd
效=dhpdpdphpd
校=hspddhpdpd
涍=ddhhshpzsh
笑=phdphdphpd
啸=szhzhhspspd
敩=ddpdzzshphpd
些=shshpzhh
揳=hshhhhszphpd
楔=hspdhhhszphpd
歇=szhhpzpdzpzpd
蝎=szhshdszhhpzpdz
协=hszpdd
邪=hzspzs
胁=pzhhzpdd
挟=hshhdphpd
偕=pshzpzpszhh
斜=pdhhspdddhs
谐=dzhzpzpszhh
携=hshpsdhhhshzp
勰=zpzpzpszhshdzdd
撷=hshhshszhhpszpd
缬=zzhhshszhhpszpd
鞋=hsshszhhshshhsh
写=dzhzh
泄=ddhhsshz
泻=ddhdzhzh
绁=zzhhsshz
卸=phhshshzs
屑=zhpsdpszhh
偰=pshhhszphpd
械=hspdhhpszpd
亵=dhhshpzdpzpd
渫=ddhhsshzhspd
谢=dzpszhhhphsd
榍=hspdzhpsdpszhh
榭=hspdpszhhhphsd
廨=dhppzszhhszpphhs
懈=ddspzpzhhszpphhs
澥=ddhpzpzhhszpphhs
獬=pzppzpzhhszpphhs
薢=hsspzpzhhszpphhs
薤=hsshpzdshhhshhhh
邂=pzpzhhszpphhsdzd
燮=dhhhszhdppddppdzd
瀣=ddhshpzdzdshhhshhhh
蟹=pzpzhhszpphhsszhshd
躞=szhshshdhhhszhdppddppdzd
心=dzdd
妡=zphpphs
忻=ddspphs
芯=hssdzdd
辛=dhdphhs
昕=szhhpphs
杺=hspddzdd
欣=pphspzpd
炘=dppdpphs
锌=phhhzdhdphhs
新=dhdphhspdpphs
歆=dhdphszhhpzpd
薪=hssdhdphhspdpphs
馨=hshzshppzzdphspdszhh
鑫=pdhhsdphpdhhsdphpdhhsdph
枔=hspdpddz
伈=psdzdd
囟=pszpdh
信=psdhhhszh
衅=pszsshdphhs
星=szhhphhsh
骍=zzhdhdphhs
惺=ddsszhhphhsh
猩=pzpszhhphhsh
煋=dppdszhhphhsh
瑆=hhshszhhphhsh
腥=pzhhszhhphhsh
刑=hhpsss
行=ppshhs
邢=hhpszs
形=hhpsppp
陉=zszdhsh
型=hhpssshsh
荥=hssdzszpd
钘=phhhzhhps
硎=hpszhhhpsss
铏=phhhzhhpsss
醒=hszpzhhszhhphhsh
擤=hshpszhhhszhshhps
兴=ddphpd
杏=hspdszh
姓=zphphhsh
幸=hshdphhs
性=ddsphhsh
荇=hssppshhs
倖=pshshdphhs
婞=zphhshdphhs
悻=ddshshdphhs
凶=pdzs
兄=szhpz
匈=pzpdzs
讻=dzpdzs
汹=ddhpdzs
胸=pzhhpzpdzs
雄=hpzdpsdhhhsh
熊=zdszhhpzpzdddd
诇=dzszszh
夐=pzszpdszhhhpzd
休=pshspd
修=psspzdppp
咻=szhpshspd
庥=dhppshspd
羞=dphhhpzshh
脩=psspzdszhh
鸺=pshspdpzdzh
貅=pddpzpppshspd
馐=pzzdphhhpzshh
髹=hshhhzdppppshspd
朽=hspdhz
滫=ddhpsspzdszhh
秀=phspdzp
岫=szsszhsh
珛=hhshhpszhh
绣=zzhphspdzp
袖=dzspdszhsh
琇=hhshphspdzp
锈=phhhzphspdzp
嗅=szhpszhhhhpdd
溴=ddhpszhhhhpdd
吁=szhhhs
戌=hphzpd
旴=szhhhhs
盱=szhhhhhs
胥=zshpdszhh
须=ppphpszpd
顼=hhshhpszpd
虚=shzphzssdph
谞=dzzshpdszhh
媭=ppphpszpdzph
湑=ddhzshpdszhh
嘘=szhshzphzssdph
墟=hshshzphzssdph
需=hdzsddddhpszss
魆=pszhhpzzdhzzpd
徐=ppspdhhspd
许=dzphhs
诩=dzzdhzdh
冔=szhhszhhhs
冔=szhhszhhhs
栩=hspdzdhzdh
珝=hhshzdhzdh
糈=dphspdzshpdszhh
醑=hszpzhhzshpdszhh
旭=pzszhh
序=dhpzdzs
叙=pdhhspdzd
恤=ddspszssh
昫=szhhpzszh
洫=ddhpszssh
垿=hshdhpzdzs
勖=szhhszhhhzp
绪=zzhhshpszhh
续=zzhhszddhpd
酗=hszpzhhpdzs
婿=zphzshpdszhh
溆=ddhpdhhspdzd
絮=zphszhzzdspd
煦=szhhpzszhdddd
蓄=hssdhzzdszhsh
蓿=hssddzpshpszhh
轩=hzshhhs
昍=szhhszhh
宣=ddzhszhhh
谖=dzpddphhpzd
喧=szhddzhszhhh
愃=ddsddzhszhhh
揎=hshddzhszhhh
萱=hssddzhszhhh
暄=szhhddzhszhhh
煊=dppdddzhszhhh
瑄=hhshddzhszhhh
儇=psszsshhszhpzpd
禤=dzsdszsshzdhzdh
翧=ddzhszhhhzdhzdh
翾=szsshhszhpzpdzdhzdh
玄=dhzzd
玹=hhshdhzzd
痃=dhpdhdhzzd
悬=szhhhzddzdd
旋=dhzpphzshpd
漩=ddhdhzpphzshpd
暶=szhhdhzpphzshpd
璇=hhshdhzpphzshpd
咺=szhhszhhh
选=phshpzdzd
晅=szhhhszhhh
烜=dppdhszhhh
癣=dhpdhpzszhshhdphhhs
泫=ddhdhzzd
昡=szhhdhzzd
炫=dppddhzzd
绚=zzhpzszhh
眩=szhhhdhzzd
铉=phhhzdhzzd
琄=hhshszhszhh
衒=ppsdhzzdhhs
渲=ddhddzhszhhh
楦=hspdddzhszhhh
碹=hpszhddzhszhhh
削=sdpszhhss
靴=hsshszhhspspz
薛=hsspszhzhdhdphhs
穴=ddzpd
学=ddpdzzsh
峃=ddpdzszs
茓=hssddzpd
踅=hshpphsszhshpd
雪=hdzsddddzhh
鳕=pzszhshhhdzsddddzhh
血=pszssh
谑=dzshzphzhzh
勋=szhszpdzp
埙=hshszhszpd
熏=phszdphshhdddd
窨=ddzpddhdphszhh
獯=pzpphszdphshhdddd
薰=hssphszdphshhdddd
曛=szhhphszdphshhdddd
醺=hszpzhhphszdphshhdddd
寻=zhhhsd
旬=pzszhh
巡=zzzdzd
驯=zzhpss
询=dzpzszhh
峋=szspzszhh
恂=ddspzszhh
洵=ddhpzszhh
浔=ddhzhhhsd
荀=hsspzszhh
荨=hsszhhhsd
栒=hspdpzszhh
珣=hhshpzszhh
循=ppspphsszhhh
鲟=pzszhshhzhhhsd
训=dzpss
讯=dzzhs
汛=ddhzhs
迅=zhsdzd
徇=ppspzszhh
逊=zshspddzd
殉=hpzdpzszhh
巽=zhzzhzhsshpd
噀=szhzhzzhzhsshpd
蕈=hsshszsshszhhhs
丫=dps
压=hphshd
吖=szhdps
押=hshszhhs
垭=hshhssdph
鸦=hzsppzdzh
桠=hspdhssdph
鸭=szhhspzdzh
牙=hzsp
伢=pshzsp
岈=szshzsp
芽=hsshzsp
玡=hhshhzsp
琊=hhshhzspzs
蚜=szhshdhzsp
堐=hshhphshhsh
崖=szshphshhsh
涯=ddhhphshhsh
睚=szhhhhphshhsh
衙=ppshszhszhhhs
哑=szhhssdph
雅=hzsppsdhhhsh
蕥=hsshzsppsdhhhsh
轧=hzshz
亚=hssdph
讶=dzhzsp
迓=hzspdzd
娅=zphhssdph
砑=hpszhhzsp
氩=phhzhssdph
揠=hshhszhhzphz
猰=pzphhhszphpd
呀=szhhzsp
恹=ddshphpdd
烟=dppdszhpdh
胭=pzhhszhpdh
崦=szshpdszhhz
淹=ddhhpdszhhz
焉=hshshhzdddd
阉=dszhpdszhhz
湮=ddhhszsshhsh
腌=pzhhhpdszhhz
鄢=hshshhzddddzs
嫣=zphhshshhzdddd
漹=ddhhshshhzdddd
延=pshzzd
闫=dszhhh
严=hssdphp
妍=zphhhps
芫=hsshhpz
言=dhhhszh
岩=szshpszh
沿=ddhpzszh
炎=dppddppd
研=hpszhhhps
盐=hshsdszssh
琂=hhshdhhhszh
阎=dszpzpshzhh
筵=phdphdpshzzd
蜒=szhshdpshzzd
颜=dhdphpppphpszpd
虤=shzphzpzshzphzpz
檐=hspdpzhppddhhhszh
沇=ddhzdpz
兖=dhpdzdpz
奄=hpdszhhz
俨=pshssdphp
弇=pdhszhhps
衍=ppsddhhhs
偃=pshszhhzphz
厣=hphpddszhhs
掩=hshhpdszhhz
眼=szhhhzhhzpd
郾=hszhhzphzzs
扊=dzhpdppddppd
棪=hspddppddppd
渰=ddhpdhszhhps
琰=hhshdppddppd
罨=szsshhpdszhhz
演=ddhddzhszhshpd
戭=ddzhszhshpdhzpd
蝘=szhshdhszhhzphz
魇=hphpddpszhhpzzd
黡=hphpddszdphshhdddd
甗=shzphzhszhszdphshzzd
鼹=pshzhhzddzddzszhhddzzph
厌=hphpdd
觃=szpzzsh
咽=szhszhpdh
彦=dhdphpppp
砚=hpszhszpz
唁=szhdhhhszh
宴=ddzszhhzph
晏=szhhddzzph
烻=dppdpshzzd
艳=hhhspzzshz
验=zzhpdhddph
谚=dzdhdphpppp
堰=hshhszhhzphz
焰=dppdpzpshzhh
焱=dppddppddppd
雁=hppspsdhhhsh
滟=ddhhhhspzzshz
墕=hshhshshhzdddd
酽=hszpzhhhssdphp
谳=dzhsszdphhshpdd
餍=hphpddpddzhhzpd
燕=hsshszhshhpzdddd
赝=hppspsdhhhshszpd
嬿=zphhsshszhshhpzdddd
央=szhpd
咉=szhszhpd
泱=ddhszhpd
殃=hpzdszhpd
秧=phspdszhpd
鸯=szhpdpzdzh
鞅=hsshszhhsszhpd
扬=hshzpp
羊=dphhhs
阳=zsszhh
旸=szhhzpp
杨=hspdzpp
炀=dppdzpp
飏=pzpdzpp
佯=psdphhhs
疡=dhpdhzpp
钖=phhhzzpp
垟=hshdphhhs
徉=ppsdphhhs
洋=ddhdphhhs
烊=dppddphhhs
蛘=szhshddphhhs
仰=pspzzs
养=dphhhpdps
氧=phhzdphhhs
痒=dhpdhdphhhs
怏=ddsszhpd
恙=dphhshdzdd
样=hspddphhhs
羕=dphhshdzzpd
漾=ddhdphhshdzzpd
幺=zzd
夭=phpd
吆=szhzzd
妖=zphphpd
腰=pzhhhszsshzph
邀=pszhhdhzpphpddzd
爻=pdpd
尧=hzphpz
肴=pdhpszhh
垚=hshhshhsh
姚=zphpdhzpd
峣=szshzphpz
轺=hzshzpszh
珧=hhshpdhzpd
窑=ddzpdphhszs
谣=dzpddpphhszs
媱=zphpddpphhszs
徭=ppspddpphhszs
摇=hshpddpphhszs
滧=ddhdhpdpdphpd
猺=pzppddpphhszs
遥=pddpphhszsdzd
瑶=hhshpddpphhszs
繇=pddpphhszspzzdspd
鳐=pzszhshhpddpphhszs
杳=hspdszhh
咬=szhdhpdpd
窅=ddzpdszhhh
窈=ddzpdzzdzp
舀=pddppshzhh
崾=szshszsshzph
药=hsszzhpzd
要=hszsshzph
钥=phhhzpzhh
靿=hsshszhhszzdzp
鹞=pddpphhszspzdzh
曜=szhhzdhzdhpsdhhhsh
耀=sdphpzzdhzdhpsdhhhsh
倻=pshsshhhzs
掖=hshdhpspzdd
椰=hspdhsshhhzs
噎=szhhshdzhszhdph
爷=pdpdzs
耶=hsshhhzs
揶=hshhsshhhzs
铘=phhhzhzspzs
也=zsz
吔=szhzsz
冶=dhzdszh
埜=hspdhspdhsh
野=szhhshhzdzs
嘢=szhszhhshhzdzs
业=ssdph
叶=szhhs
曳=szhhzp
页=hpszpd
邺=ssdphzs
夜=dhpspzdd
晔=szhhpspzhs
烨=dppdpspzhs
液=ddhdhpspzdd
谒=dzszhhpzpdz
堨=hshszhhpzpdz
腋=pzhhdhpspzdd
楪=hspdhsshzhspd
馌=pzzhshzdszssh
靥=hphpddhpszsshhh
一=h
伊=pszhhp
衣=dhpzpd
医=hphhpdz
依=psdhpzpd
祎=dzsdhhzs
咿=szhpszhhp
洢=ddhpszhhp
猗=pzphpdhszhs
铱=phhhzdhpzpd
壹=hshdzhszhdph
揖=hshszhhsshhh
欹=hpdhszhspzpd
漪=ddhpzphpdhszhs
噫=szhdhdphszhhdzdd
繄=hphhpdzpzzdzzdspd
黟=szdphshhddddpzdpzd
仪=psdpd
匜=hzszz
圯=hshzhz
夷=hzhzpd
沂=ddhpphs
诒=dzzdszh
宜=ddzszhhh
怡=ddszdszh
迤=phzszdzd
饴=pzzzdszh
咦=szhhzhzpd
姨=zphhzhzpd
贻=szpdzdszh
宧=ddzhsszhsz
扅=dzhppzdpzd
眙=szhhhzdszh
胰=pzhhhzhzpd
痍=dhpdhhzhzpd
移=phspdpzdpzd
遗=szhshszpddzd
椸=hspddhzpphzsz
颐=hsszhszhpszpd
疑=pzphhpdzdzshpd
嶷=szspzphhpdzdzshpd
簃=phdphdphspdpzdpzd
彝=zzhdphspdzzdspdhps
乙=z
已=zhz
以=zdpd
钇=phhhzz
佁=pszdszh
矣=zdphhpd
苡=hsszdpd
舣=ppzdhddpd
蚁=szhshddpd
倚=pshpdhszhs
扆=dzhpdhpzpd
酏=hszpzhhzsz
椅=hspdhpdhszhs
旖=dhzpphhpdhszhs
踦=szhshshhpdhszhs
乂=pd
义=dpd
亿=psz
弋=hzd
刈=pdss
忆=ddsz
艺=hssz
议=dzdpd
亦=dhpspd
屹=szsphz
异=zhzhps
佚=psphhpd
呓=szhhssz
役=ppspzzd
抑=hshpzzs
杙=hspdhzd
译=dzzdhhs
邑=szhzshz
佾=pspdszhh
峄=szszdhhs
怿=ddszdhhs
易=szhhpzpp
枍=hspdpdhz
绎=zzhzdhhs
诣=dzpzszhh
驿=zzhzdhhs
奕=dhpspdhps
弈=dhpspdhps
疫=dhpdhpzzd
羿=zdhzdhhps
轶=hzshphhpd
悒=ddsszhzshz
挹=hshszhzshz
浥=ddhszhzshz
益=dphpdszssh
谊=dzddzszhhh
勚=hsshzszpdzp
埸=hshszhhpzpp
翊=dhdphzdhzdh
翌=zdhzdhdhdph
逸=pzszhpzddzd
晹=szhhszhhpzpp
意=dhdphszhhdzdd
溢=ddhdphpdszssh
缢=zzhdphpdszssh
肄=pzphhpdzhhhhs
裔=dhpzpdszpdszh
裛=dhszhzshzpzpd
嫕=zphhphhpdzdzdd
廙=dhpszhshhsshpd
潩=ddhszhshhsshpd
瘗=dhpdhhdphpdhsh
蜴=szhshdszhhpzpp
毅=dhdphpzpppdpzzd
熠=dppdzdhzdhpszhh
镒=phhhzdphpdszssh
鹝=hszhszdphspzdzh
鹢=dphpdszsshpzdzh
劓=pszhhhszhshhpsss
殪=hpzdhshdzhszhdph
燚=dppddppddppddppd
薏=hssdhdphszhhdzdd
螠=szhshddphpdszssh
翳=hphhpdzpzzdzdhzdh
翼=zdhzdhszhshhsshpd
臆=pzhhdhdphszhhdzdd
癔=dhpdhdhdphszhhdzdd
镱=phhhzdhdphszhhdzdd
懿=hshdzhszhdphdhpzpddzdd
因=szhpdh
阴=zspzhh
姻=zphszhpdh
洇=ddhszhpdh
茵=hssszhpdh
荫=hsszspzhh
音=dhdphszhh
骃=zzhszhpdh
殷=ppzhhzpzzd
氤=phhzszhpdh
铟=phhhzszhpdh
喑=szhdhdphszhh
堙=hshhszsshhsh
愔=ddsdhdphszhh
歅=hszsshhshpzpd
溵=ddhppzhhzpzzd
禋=dzsdhszsshhsh
吟=szhpddz
烎=hhpsdppd
垠=hshzhhzpd
狺=pzpdhhhszh
珢=hhshzhhzpd
訚=dszdhhhszh
寅=ddzhszhshpd
崟=szspdhhsdph
淫=ddhpddpphsh
银=phhhzzhhzpd
龂=shshpdzspphs
鄞=hsshszhhhshzs
夤=pzdddzhszhshpd
嚚=szhszhhszhszszhszh
蟫=szhshdhszsshszhhhs
霪=hdzsddddddhpddpphsh
尹=zhhp
引=zhzs
吲=szhzhzs
饮=pzzpzpd
蚓=szhshdzhzs
隐=zspzzhhdzdd
瘾=dhpdhzspzzhhdzdd
印=pzhzs
茚=hsspzhzs
胤=pzzdszhhz
慭=hdphspdhpdddzdd
应=dhpddph
英=hssszhpd
桜=hspdddpzph
莺=hssdzpzdzh
婴=szpdszpdzph
媖=zphhssszhpd
瑛=hhshhssszhpd
锳=phhhzhssszhpd
嘤=szhszpdszpdzph
撄=hshszpdszpdzph
缨=zzhszpdszpdzph
罂=szpdszpdphhszs
樱=hspdszpdszpdzph
璎=hhshszpdszpdzph
鹦=szpdszpdzphpzdzh
膺=dhppspsdhhhshszhh
鹰=dhppspsdhhhshpzdzh
迎=pzzsdzd
茔=hssdzhsh
盈=zpzdszssh
荧=hssdzdppd
莹=hssdzhhshd
萤=hssdzszhshd
营=hssdzszhszh
萦=hssdzzzdspd
溁=ddhhssdzhspd
楹=hspdzpzdszssh
滢=ddhhssdzhhshd
蓥=hssdzpdhhsdph
潆=ddhhssdzzzdspd
蝇=szhshdszhszhhz
嬴=dhzszhpzhhzphpzd
赢=dhzszhpzhhszpdpzd
瀛=ddhdhzszhpzhhzphpzd
郢=szhhhshzs
颍=pzszpdhpszpd
颖=pzphspdhpszpd
影=szhhdhszhspdppp
瘿=dhpdhszpdszpdzph
映=szhhszhpd
硬=hpszhhszhhpd
媵=pzhhdphhpdzph
哟=szhzzhpzd
唷=szhdhzdszhh
佣=pspzhhs
拥=hshpzhhs
痈=dhpdhpzhhs
邕=zzzszhzshz
庸=dhpzhhszhhs
鄘=dhpzhhszhhszs
雍=dhzzppsdhhhsh
墉=hshdhpzhhszhhs
慵=ddsdhpzhhszhhs
壅=dhzzppsdhhhshhsh
澭=ddhdhzzppsdhhhsh
镛=phhhzdhpzhhszhhs
臃=pzhhdhzzppsdhhhsh
鳙=pzszhshhdhpzhhszhhs
饔=dhzzppsdhhhshpddzhhzpd
喁=szhszhhszshd
颙=szhhszshdhpszpd
永=dzzpd
甬=zdszhhs
咏=szhdzzpd
泳=ddhdzzpd
俑=pszdszhhs
勇=zdszhhszp
栐=hspddzzpd
埇=hshzdszhhs
涌=ddhzdszhhs
恿=zdszhhsdzdd
蛹=szhshdzdszhhs
踊=szhshshzdszhhs
鲬=pzszhshhzdszhhs
用=pzhhs
优=pshpzd
忧=ddshpzd
攸=pssphpd
呦=szhzzdzp
幽=szzdzzdzs
悠=pssphpddzdd
麀=dhpzsshhzpzpz
耰=hhhspdhpszhhdzdzddpzd
尢=hpz
尤=hpzd
由=szhsh
犹=pzphpzd
邮=szhshzs
油=ddhszhsh
疣=dhpdhhpzd
浟=ddhpssphpd
莜=hsspssphpd
莸=hsspzphpzd
铀=phhhzszhsh
蚰=szhshdszhsh
游=ddhdhzpphzsh
鱿=pzszhshhhpzd
猷=dphszpzhhhpdd
鲉=pzszhshhszhsh
蝣=szhshddhzpphzsh
友=hpzd
有=hpszhh
卣=shszzhh
酉=hszpzhh
羑=dphhshpzd
莠=hssphspdzp
铕=phhhzhpszhh
槱=hspdhszpzhhdddd
牖=pshzdzhphszhhsd
黝=szdphshhddddzzdzp
又=zd
右=hpszh
幼=zzdzp
佑=pshpszh
侑=pshpszhh
囿=szhpszhhh
宥=ddzhpszhh
柚=hspdszhsh
祐=dzsdhpszh
诱=dzphspdzp
蚴=szhshdzzdzp
釉=pdphspdszhsh
鼬=pshzhhzddzddzszhsh
込=pddzd
纡=zzhhhs
迂=hhsdzd
淤=ddhdhzppddd
瘀=dhpdhdhzppddd
于=hhs
邘=hhszs
余=pdhhspd
妤=zphzdzs
欤=hzhpzpd
玙=hhshhzh
於=dhzppddd
盂=hhsszssh
臾=pshzhhpd
鱼=pzszhshh
俞=pdhszhhss
禺=szhhszshd
竽=phdphdhhs
舁=pshzhhhps
娱=zphszhhhpd
狳=pzppdhhspd
谀=dzphszhhpd
渔=ddhpzszhshh
萸=hsspshzhhpd
隅=zsszhhszshd
雩=hdzsddddhhz
嵎=szsszhhszshd
嵛=szspdhszhhss
愉=ddspdhszhhss
揄=hshpdhszhhss
渝=ddhpdhszhhss
腴=pzhhpshzhhpd
逾=pdhszhhssdzd
愚=szhhszshddzdd
榆=hspdpdhszhhss
瑜=hhshpdhszhhss
艅=ppzdhdpdhhspd
虞=shzphzszhhhpd
觎=pdhszhhssszpz
窬=ddzpdpdhszhhss
舆=pshhhzhszhhhpd
褕=dzspdpdhszhhss
蝓=szhshdpdhszhhss
髃=szzdzszhhszhhszshd
与=hzh
予=zdzs
伛=pshpdz
宇=ddzhhs
屿=szshzh
羽=zdhzdh
雨=hszsdddd
俣=psszhhhpd
禹=pszhszshd
语=dzhszhszh
圄=szhszhszhh
峿=szshszhszh
圉=szhshdphhsh
庾=dhppshzhhpd
敔=hszhszhphpd
鄅=pszhszshdzs
瑀=hhshpszhszshd
瘐=dhpdhpshzhhpd
窳=ddzpdppzddppzdd
龉=shshpdzshszhszh
玉=hhshd
驭=zzhzd
圫=hshphz
聿=zhhhhs
芋=hsshhs
妪=zphhpdz
饫=pzzphpd
育=dhzdszhh
郁=hpszhhzs
昱=szhhdhdph
狱=pzpdzhpdd
峪=szspdpdszh
彧=hszhhzpppd
浴=ddhpdpdszh
钰=phhhzhhshd
预=zdzshpszpd
域=hshhszhhzpd
堉=hshdhzdszhh
悆=pdhhspddzdd
欲=pdpdszhpzpd
淯=ddhdhzdszhh
谕=dzpdhszhhss
阈=dszhszhhzpd
喻=szhpdhszhhss
寓=ddzszhhszshd
御=ppsphhshshzs
棫=hspdhszhhzpd
矞=zdzspszpdszh
裕=dzspdpdpdszh
遇=szhhszshddzd
鹆=pdpdszhpzdzh
愈=pdhszhhssdzdd
滪=ddhzdzshpszpd
煜=dppdszhhdhdph
蓣=hsszdzshpszpd
誉=ddphpddhhhszh
毓=phzzdhddhzdpsz
蜮=szhshdhszhhzpd
潏=ddhzdzspszpdszh
薁=hsspszdphspdhpd
豫=zdzspzszhpzpppd
遹=zdzspszpdszhdzd
燏=dppdzdzspszpdszh
燠=dppdpszdphspdhpd
鹬=zdzspszpdszhpzdzh
鬻=zhzdphspdzhzhszhszdphs
鸢=hzdpzdzh
冤=dzpzszhpzd
眢=pzdzzszhhh
鸳=pzdzzpzdzh
渊=ddhpdphspds
蜎=szhshdszhszhh
箢=phdphdddzpzdzz
元=hhpz
円=szsh
员=szhszpd
园=szhhpzh
沅=ddhhhpz
垣=hshhszhhh
爰=pddphhpzd
原=hppszhhspd
圆=szszhszpdh
袁=hshszhpzpd
援=hshpddphhpzd
湲=ddhpddphhpzd
缘=zzhzzhpzpppd
鼋=hhpzszhszhhz
塬=hshhppszhhspd
嫄=zphhppszhhspd
源=ddhhppszhhspd
猿=pzphshszhpzpd
辕=hzshhshszhpzpd
橼=hspdzzhzzhpzpppd
羱=dphhhphppszhhspd
螈=szhshdhppszhhspd
远=hhpzdzd
苑=hsspzdzz
怨=pzdzzdzdd
院=zsddzhhpz
垸=hshddzhhpz
媛=zphpddphhpzd
掾=hshzzhpzpppd
瑗=hhshpddphhpzd
愿=hppszhhspddzdd
曰=szhh
约=zzhpzd
彟=zhhhsdhsspsdhhhshzd
月=pzhh
刖=pzhhss
妜=zphzhpd
岳=pshshszs
玥=hhshpzhh
悦=ddsdpszhpz
钺=phhhzhzzpd
阅=dszdpszhpz
跃=szhshshphpd
粤=pszdphspdhhz
越=hshshpdhzzpd
樾=hspdhshshpdhzzpd
龠=pdhszhszhszhszhss
瀹=ddhpdhszhszhszhszhss
爚=dppdpdhszhszhszhszhss
籥=phdphdpdhszhszhszhszhss
晕=szhhdzhzhs
缊=zzhszhhszssh
氲=phhzszhhszssh
煴=dppdszhhszssh
赟=dhpdhhshshzdszpd
馧=phspdszhhszhhszssh
云=hhzd
匀=pzdh
妘=zphhhzd
沄=ddhhhzd
纭=zzhhhzd
芸=hsshhzd
昀=szhhpzdh
郧=szhszpdzs
涢=ddhszhszpd
耘=hhhspdhhzd
筠=phdphdhshpzdh
筼=phdphdszhszpd
鋆=hshpzdhpdhhsdph
允=zdpz
狁=pzpzdpz
陨=zsszhszpd
殒=hpzdszhszpd
孕=zpzsh
运=hhzddzd
郓=dzhzshzs
恽=ddsdzhzhs
酝=hszpzhhhhzd
愠=ddsszhhszssh
韫=hhzsszhhszssh
韵=dhdphszhhpzdh
熨=zhphhspdhsddppd
蕴=hsszzhszhhszssh
匝=hszsz
咂=szhhszsz
拶=hshzzzpzd
臜=pzhhphshpzphshpzszpd
杂=pzhspd
砸=hpszhhszsz
咋=szhphshh
灾=ddzdppd
甾=zzzszhsh
哉=hshszhzpd
栽=hshhspdzpd
宰=ddzdhdphhs
崽=szsszhshdzdd
再=hszshh
在=hpshsh
载=hshhzshzpd
糌=dphspdpzdsdszhh
簪=phdphdhzpzhzpzszhh
咱=szhpszhhh
昝=pzdsdszhh
寁=ddzhzhhshpd
攒=hshphshpzphshpzszpd
趱=hshshpdphshpzphshpzszpd
暂=hzshpphsszhh
赞=phshpzphshpzszpd
錾=hzshpphspdhhsdph
瓒=hhshphshpzphshpzszpd
牂=zshpdphhhs
赃=szpddhphsh
臧=hpzhphszhszzpd
驵=zzhszhhh
奘=zshphshhpd
奘=zshphshhpd
脏=pzhhdhphsh
葬=hsshpzdpzhps
遭=hszhsshszhhdzd
糟=dphspdhszhsshszhh
凿=ssdphdphhszs
早=szhhhs
枣=hszspddd
蚤=zddszhshd
澡=ddhszhszhszhhspd
璪=hhshszhszhszhhspd
藻=hssddhszhszhszhhspd
灶=dppdhsh
皂=pszhhhz
唣=szhpszhhhz
造=phshszhdzd
慥=ddsphshszhdzd
噪=szhszhszhszhhspd
簉=phdphdphshszhdzd
燥=dppdszhszhszhhspd
躁=szhshshszhszhszhhspd
则=szpdss
沢=ddhzhpd
择=hshzdhhs
泽=ddhzdhhs
责=hhshszpd
迮=phshhdzd
啧=szhhhshszpd
帻=szshhshszpd
笮=phdphdphshh
舴=ppzdhdphshh
箦=phdphdhhshszpd
赜=hsszhszhhshszpd
仄=hppd
昃=szhhhppd
贼=szpdhhpzpd
鲗=pzszhshhszpdss
怎=phshhdzdd
谮=dzhzpzhzpzszhh
鄫=dpszsdphszhhzs
增=hshdpszsdphszhh
憎=ddsdpszsdphszhh
缯=zzhdpszsdphszhh
矰=phhpddpszsdphszhh
罾=szsshdpszsdphszhh
锃=phhhzszhhhsh
甑=dpszsdphszhhhzzd
赠=szpddpszsdphszhh
扎=hshz
吒=szhphz
奓=hpdpzdpzd
挓=hshddzphz
哳=szhhshpphs
喳=szhhspdszhhh
揸=hshhspdszhhh
渣=ddhhspdszhhh
楂=hspdhspdszhhh
劄=phdphdpdhszhss
齇=pszhhhszhshhpsshzphzszhhh
札=hspdz
闸=dszszhhs
铡=phhhzszpdss
拃=hshphshh
眨=szhhhpdzd
砟=hpszhphshh
鲊=pzszhshhphshh
鲝=dphhhppzszhshh
乍=phshh
诈=dzphshh
咤=szhddzphz
柞=hspdphshh
栅=hspdpzpzh
炸=dppdphshh
痄=dhpdhphshh
蚱=szhshdphshh
溠=ddhdphhhphsh
榨=hspdddzpdphshh
霅=hdzsdddddhhhszh
斋=dhpdhpszss
摘=hshdhdpszhsszh
宅=ddzphz
窄=ddzpdphshh
债=pshhshszpd
砦=shshpzhpszh
寨=ddzhhsshpdhspd
瘵=dhpdhpzddzdhhspd
沾=ddhshszh
毡=phhzshszh
旃=dhzpphpzdh
栴=hspdphpzdh
粘=dphspdshszh
詹=pzhppddhhhszh
谵=dzpzhppddhhhszh
嶦=szspzhppddhhhszh
瞻=szhhhpzhppddhhhszh
鹯=dhszszhhszhhhpzdzh
鳣=pzszhshhdhszszhhszhhh
斩=hzshpphs
飐=pzpdshszh
展=zhphsshzpd
盏=hhzpdszssh
崭=szshzshpphs
搌=hshzhphsshzpd
占=shszh
战=shszhhzpd
栈=hspdhhzpd
站=dhdphshszh
偡=pshsshhhpdz
绽=zzhddzhshpd
湛=ddhhsshhhpdz
蘸=hsshszpzhhpsdhhhshdddd
张=zhzphzd
章=dhdphszhhhs
鄣=dhdphszhhhszs
嫜=zphdhdphszhhhs
彰=dhdphszhhhsppp
漳=ddhdhdphszhhhs
獐=pzpdhdphszhhhs
暲=szhhdhdphszhhhs
樟=hspddhdphszhhhs
璋=hhshdhdphszhhhs
蟑=szhshddhdphszhhhs
仉=pspz
长=phzd
涨=ddhzhzphzd
掌=sdpdzszhphhs
丈=hpd
仗=pshpd
帐=szsphzd
杖=hspdhpd
胀=pzhhphzd
账=szpdphzd
障=zsdhdphszhhhs
嶂=szsdhdphszhhhs
幛=szsdhdphszhhhs
瘴=dhpdhdhdphszhhhs
钊=phhhzss
招=hshzpszh
昭=szhhzpszh
啁=szhpzhshszh
爪=ppsd
找=hshhzpd
沼=ddhzpszh
召=zpszh
兆=pdhzpd
诏=dzzpszh
炤=dppdzpszh
赵=hshshpdpd
笊=phdphdppsd
旐=dhzpphpdhzpd
棹=hspdshszhhhs
照=szhhzpszhdddd
罩=szsshshszhhhs
肇=dzhpphpdzhhhhs
曌=szhhpzhhddzpdhsh
蜇=hshpphsszhshd
嗻=szhdhphsshdddd
遮=dhphsshdddddzd
折=hshpphs
哲=hshpphsszh
晢=hshpphsszhh
辄=hzshhsshhhz
喆=hshszhhshszh
蛰=hshpzdszhshd
詟=hpzpddhhhszh
谪=dzdhdpszhsszh
磔=hpszhpzdhzshspd
辙=hzshdhzdszhhphpd
者=hshpszhh
啫=szhhshpszhh
锗=phhhzhshpszhh
赭=hshpspdhshpszhh
褶=dzspdzdhzdhpszhh
这=dhpddzd
柘=hspdhpszh
浙=ddhhshpphs
蔗=hssdhphsshdddd
鹧=dhphsshddddpzdzh
着=dphhhpszhhh
著=hsshshpszhh
贞=shszpd
针=phhhzhs
侦=psshszpd
浈=ddhshszpd
珍=hhshpdppp
胗=pzhhpdppp
桢=hspdshszpd
真=hsszhhhhpd
砧=hpszhshszh
祯=dzsdshszpd
葴=hsshphszhzpd
斟=hsshhhpdzddhs
甄=hszsshhshhzzd
蓁=hsshhhpdphspd
榛=hspdhhhpdphspd
瑧=hhshhhhpdphspd
禛=dzsdhsszhhhhpd
箴=phdphdhphszhzpd
臻=hzdhshhhhpdphspd
诊=dzpdppp
枕=hspddzpz
昣=szhhpdppp
轸=hzshpdppp
畛=szhshpdppp
疹=dhpdhpdppp
袗=dzspdpdppp
缜=zzhhsszhhhhpd
稹=phspdhsszhhhhpd
鬒=hshhhzdppphsszhhhhpd
圳=hshpss
阵=zshzhs
纼=zzhzhzs
鸩=dzpzpzdzh
振=hshhphhzpd
朕=pzhhdphhpd
赈=szpdhphhzpd
揕=hshhsshhhpdz
瑱=hhshhsszhhhhpd
镇=phhhzhsszhhhhpd
震=hdzsddddhphhzpd
争=pzzhhs
征=ppshshsh
怔=ddshshsh
诤=dzpzzhhs
峥=szspzzhhs
挣=hshpzzhhs
狰=pzppzzhhs
烝=zszpdhdddd
钲=phhhzhshsh
睁=szhhhpzzhhs
铮=phhhzpzzhhs
筝=phdphdpzzhhs
蒸=hsszszpdhdddd
拯=hshzszpdh
掟=hshddzhshpd
整=hszhspdphpdhshsh
正=hshsh
证=dzhshsh
郑=dphhpdzs
帧=szsshszpd
政=hshshphpd
症=dhpdhhshsh
之=dzd
支=hszd
卮=pphzz
汁=ddhhs
芝=hssdzd
吱=szhhszd
枝=hspdhszd
泜=ddhpzhzd
知=phhpdszh
织=zzhszhpd
肢=pzhhhszd
栀=hspdpphzz
祗=dzsdpzhzd
胝=pzhhpzhzd
脂=pzhhpzszhh
禔=dzsdszhhhshpd
稙=phspdhsszhhhh
榰=hspdhshppzszhh
蜘=szhshdphhpdszh
执=hshpzd
侄=pshzdhsh
直=hsszhhhh
值=pshsszhhhh
埴=hshhsszhhhh
职=hsshhhszhpd
植=hspdhsszhhhh
殖=hpzdhsszhhhh
絷=hshpzdzzdspd
跖=szhshshhpszh
摭=hshdhphsshdddd
踯=szhshshdphhpdzs
止=shsh
只=szhpd
凪=pzshsh
旨=pzszhh
址=hshshsh
扺=hshpzhz
沚=ddhshsh
纸=zzhpzhz
芷=hssshsh
祉=dzsdshsh
茋=hsspzhzd
咫=zhpdszhpd
指=hshpzszhh
枳=hspdszhpd
轵=hzshszhpd
趾=szhshshshsh
黹=ssdphdpszspd
酯=hszpzhhpzszhh
徵=ppsszshhhshphpd
至=hzdhsh
志=hshdzdd
忮=ddshszd
豸=pddpzpp
制=phhszsss
帙=szsphhpd
帜=szsszhpd
治=ddhzdszh
炙=pzdddppd
质=pphsszpd
郅=hzdhshzs
峙=szshshhsd
庤=dhphshhsd
栉=hspdhsszs
陟=zsshshspp
挚=hshpzdphhs
晊=szhhhzdhsh
桎=hspdhzdhsh
秩=phspdphhpd
致=hzdhshphpd
贽=hshpzdszpd
轾=hzshhzdhsh
掷=hshdphhpdzs
梽=hspdhshdzdd
畤=szhshhshhsd
痔=dhpdhhshhsd
窒=ddzpdhzdhsh
铚=phhhzhzdhsh
鸷=hshpzdpzdzh
彘=zzhphhpdhzpz
智=phhpdszhszhh
滞=ddhhsssdzszs
痣=dhpdhhshdzdd
蛭=szhshdhzdhsh
骘=zsshshsppzzh
滍=ddhzsshszhshd
稚=phspdpsdhhhsh
置=szsshhsszhhhh
跱=szhshshhshhsd
锧=phhhzpphsszpd
雉=phhpdpsdhhhsh
疐=hsdzszhshzshpd
觯=pzpzhhsdpszhhhs
踬=szhshshpphsszpd
中=szhs
忠=szhsdzdd
终=zzhpzddd
柊=hspdpzddd
盅=szhsszssh
钟=phhhzszhs
舯=ppzdhdszhs
衷=dhszhspzpd
锺=phhhzphszhhshh
螽=pzdddszhshdszhshd
肿=pzhhszhs
种=phspdszhs
冢=dzhpzppdpd
踵=szhshshphszhhshh
穜=phspddhdphszhhshh
仲=psszhs
众=pdpdpd
茽=hsspsszhs
重=phszhhshh
州=dpdsds
舟=ppzdhd
诌=dzpzzhh
周=pzhshszh
洲=ddhdpdsds
辀=hzshppzdhd
鸼=ppzdhdpzdzh
粥=zhzdphspdzhz
赒=szpdpzhshszh
妯=zphszhsh
轴=hzshszhsh
肘=pzhhhsd
帚=zhhdzszs
纣=zzhhsd
咒=szhszhpz
宙=ddzszhsh
绉=zzhpzzhh
昼=zhpdszhhh
胄=szhshszhh
荮=hsszzhhsd
皱=pzzhhzpszd
酎=hszpzhhhsd
骤=zzhhsshhhzdpspppd
籀=phdphdhshpzdzpszhsh
朱=phhspd
侏=psphhspd
诛=dzphhspd
邾=phhspdzs
洙=ddhphhspd
茱=hssphhspd
株=hspdphhspd
珠=hhshphhspd
诸=dzhshpszhh
猪=pzphshpszhh
铢=phhhzphhspd
蛛=szhshdphhspd
槠=hspddzhshpszhh
潴=ddhpzphshpszhh
橥=pzphshpszhhhspd
竹=phsphs
竺=phdphdhh
烛=dppdszhshd
逐=hpzpppddzd
舳=ppzdhdszhsh
瘃=dhpdhhpzppdpd
蠋=szhshdszsshpzszhshd
躅=szhshshszsshpzszhshd
主=dhhsh
拄=hshdhhsh
渚=ddhhshpszhh
煮=hshpszhhdddd
嘱=szhzhppszhszshd
麈=dhpzsshhzpzdhhsh
瞩=szhhhzhppszhszshd
伫=psddzh
住=psdhhsh
助=szhhhzp
纻=zzhddzh
苎=hssddzh
杼=hspdzdzs
注=ddhdhhsh
贮=szpdddzh
驻=zzhdhhsh
柱=hspddhhsh
炷=dppddhhsh
祝=dzsdszhpz
疰=dhpdhdhhsh
砫=hpszhdhhsh
蛀=szhshddhhsh
筑=phdphdhshpzd
铸=phhhzhhhphsd
箸=phdphdhshpszhh
翥=hshpszhhzdhzdh
抓=hshppsd
髽=hshhhzdppppdpdhsh
拽=hshszhhzp
跩=szhshshszhhzp
专=hhzd
砖=hpszhhhzd
颛=szshpszsshpszpd
转=hzshhhzd
啭=szhhzshhhzd
瑑=hhshzzhpzpppd
僎=pszhzzhzhsshpd
赚=szpddphzhhsspd
撰=hshzhzzhzhsshpd
篆=phdphdzzhpzpppd
馔=pzzzhzzhzhsshpd
妆=dhszph
庄=dhphsh
桩=hspddhphsh
装=dhshshdhpzpd
壮=dhshsh
状=dhshpdd
漴=ddhszsddzhhspd
撞=hshdhdphszhhshh
隹=psdhhhsh
追=pszhzhdzd
骓=zzhpsdhhhsh
锥=phhhzpsdhhhsh
坠=zspdhsh
缀=zzhzdzdzdzd
惴=ddsszshpszss
缒=zzhpszhzhdzd
赘=hhshzpphpdszpd
肫=pzhhhzsz
窀=ddzpdhzsz
谆=dzdhszhzsh
衠=ppshsszhhhhpdhhs
准=dhpsdhhhsh
卓=shszhhhs
拙=hshzsszs
倬=psshszhhhs
捉=hshszhshpd
桌=shszhhhspd
棁=hspddpszhpz
涿=ddhhpzppdpd
汋=ddhpzd
灼=dppdpzd
叕=zdzdzdzd
茁=hsszsszs
斫=hpszhpphs
浊=ddhszhshd
浞=ddhszhshpd
诼=dzhpzppdpd
酌=hszpzhhpzd
啄=szhhpzppdpd
晫=szhhshszhhhs
椓=hspdhpzppdpd
禚=dzsddphhshdddd
擢=hshzdhzdhpsdhhhsh
濯=ddhzdhzdhpsdhhhsh
镯=phhhzszsshpzszhshd
孜=zshphpd
兹=dphzzdzzd
咨=dhpzpdszh
姿=dhpzpdzph
赀=shshpzszpd
资=dhpzpdszpd
淄=ddhzzzszhsh
缁=zzhzzzszhsh
嗞=szhdphzzdzzd
孳=dphzzdzzdzsh
嵫=szsdphzzdzzd
滋=ddhdphzzdzzd
粢=dhpzpddphspd
辎=hzshzzzszhsh
鄑=hssdphszhhzs
觜=shshpzpzpzhhs
訾=shshpzdhhhszh
趑=hshshpddhpzpd
锱=phhhzzzzszhsh
镃=phhhzdphzzdzzd
龇=shshpdzsshshpz
鼒=hspszhhhzhpshsz
髭=hshhhzdpppshshpz
鲻=pzszhshhzzzszhsh
仔=pszsh
姊=zphpzsp
秭=phspdpzsp
籽=dphspdzsh
耔=hhhspdzsh
虸=szhshdzsh
笫=phdphdpzsp
梓=hspddhdphhs
紫=shshpzzzdspd
滓=ddhddzdhdphhs
字=ddzzsh
自=pszhhh
恣=dhpzpddzdd
渍=ddhhhshszpd
眦=szhhhshshpz
子=zsh
宗=ddzhhspd
倧=psddzhhspd
综=zzhddzhhspd
棕=hspdddzhhspd
腙=pzhhddzhhspd
踪=szhshshddzhhspd
鬃=hshhhzdpppddzhhspd
鬷=hszhszdphspdzspdpzd
总=dpszhdzdd
偬=pspzppddzdd
纵=zzhpdpd
疭=dhpdhpdpd
粽=dphspdddzhhspd
邹=pzzhhzs
驺=zzhpzzhh
诹=dzhsshhhzd
陬=zshsshhhzd
鄹=hsshhhzdpspppdzs
鲰=pzszhshhhsshhhzd
走=hshshpd
奏=hhhpdhhpd
揍=hshhhhpdhhpd
租=phspdszhhh
足=szhshpd
卒=dhpdpdhs
崒=szsdhpdpdhs
族=dhzpphphhpd
镞=phhhzdhzpphphhpd
诅=dzszhhh
阻=zsszhhh
组=zzhszhhh
俎=pdpdszhhh
珇=hhshszhhh
祖=dzsdszhhh
钻=phhhzshszh
躜=szhshshphshpzphshpzszpd
缵=zzhphshpzphshpzszpd
纂=phdphdszhhhhpdzzdspd
攥=hshphdphdszhhhhpdzzdspd
嘴=szhshshpzpzpzhhs
最=szhhhsshhhzd
罪=szsshshhhshhh
槜=hspdpsdhhhshzp
蕞=hssszhhhsshhhzd
醉=hszpzhhdhpdpdhs
尊=dphszpzhhhsd
嶟=szsdphszpzhhhsd
遵=dphszpzhhhsddzd
樽=hspddphszpzhhhsd
鳟=pzszhshhdphszpzhhhsd
僔=psdphszpzhhhsd
噂=szhdphszpzhhhsd
撙=hshdphszpzhhhsd
昨=szhhphshh
捽=hshdhpdpdhs
琢=hhshhpzppdpd
左=hphsh
佐=pshphsh
作=psphshh
坐=pdpdhsh
阼=zsphshh
岞=szsphshh
怍=ddsphshh
祚=dzsdphshh
胙=pzhhphshh
唑=szhpdpdhsh
座=dhppdpdhsh
做=pshsszhphpd
咗=szhhphsh
鿎=hh
鿏=hs
鿔=hz
㑇=pspzzhh
㑊=psdhpspd
㕮=szhpdpd
㗎=szhzpszhhspd
㘎=szhdszzhsshhhphpd
㙍=hshzdzdzdzd
㙘=hshhszsshzph
㙦=pdhhspdddhshsh
㛃=hhshzpzph
㛚=zphzdszhhs
㛹=zphpshszhhpd
㞎=zhpzshz
㞗=zhphsdhpdd
㟃=szszhszh
㠇=szsdhszhspdhpzd
㠓=szshssdzhhpzpppd
㤘=ddspzzhh
㥄=ddshshpdpzd
㧐=hshzdzd
㧑=hshdpzd
㧟=hshddhhz
㨃=hshdhszhzsh
㨄=hshpzhshszh
㫰=szhhdzhhzpd
㬊=szhhpddphhpzd
㬎=szhhzzdzzddddd
㬚=szhhdhzdszhhphpd
㭎=hspdszpd
㭕=hspdhshzd
㮾=dzhhzdpzhhhspd
㰀=hspdphspdpzppdsdhpd
㳇=ddhpdpd
㳘=ddhdhzdpz
㳚=ddhhpdzpd
㴔=ddhpzzhhdzdd
㵐=ddhhpdphzsppzpd
㶲=dppdpzhhs
㸆=dppdphshszhshhhshhh
㸌=dppdhdzsddddpsdhhhsh
㺄=pzppdhszhhss
㻬=hhshhdzsddddhhz
㽏=ddhpdhszhhsshh
㿠=pszhhsdphpz
䁖=szhhhdphspdzph
䂮=hhhszphpszh
䃅=hpszhdpszhhhs
䃎=hpszhhpdpzdpzd
䅟=phspdzdhpdppp
䌷=zzhszhsh
䌹=zzhszszh
䎃=szshhzdhzdh
䎖=dpszsdphszhhzdhzdh
䏝=pzhhhhzd
䏡=pzhhhhspd
䏲=pzhhdpzhzsp
䐃=pzhhszphspdh
䓖=hssddzpdzp
䓛=hsszhpzsszs
䓨=hssdzphhszs
䓫=hsshpdhszhs
䓬=hssshszhhhs
䗖=szhshdhsssdzszs
䗛=szhshdpsspzdszhh
䗪=dhphsshddddszhshd
䗴=szhshdphdphdphshzd
䜣=dzpphs
䝙=pddpzpphpdz
䢺=zsszszs
䢼=hsshpdzs
䣘=spddzszhhshzs
䥽=phhhzzpzdd
䦃=phhhzhsshshpszhh
䲟=pzszhshhpzhzs
䲠=pzszhshhhhhpdszhh
䲢=pzhhdphhpdpzszhshh
䴓=hszspzdzh
䴔=dhpdpdpzdzh
䴕=hpzdsspzdzh
䴖=hhshszhhpzdzh
䴗=szhhhhpddpzdzh
䴘=ppshzphzpzpzdzh
䴙=zhpszhdhdphhspzdzh
䶮=hpzpdhhpd
𠅤=dhszhshdzdd
𠙶=zszs
𠳐=szhhhhpzs
𡎚=hshpzhpszhss
𡐓=hshdhpzhhsdhpd
𣗋=hspdsdpdzszhpz
𣲗=ddhhhzs
𣲘=ddhhhpz
𣸣=ddhhshssszpd
𤧛=hhshdhdpdzszs
𤩽=hhshhsszdphhshpdd
𤫉=hhshdhhhszhdppddppdzd
𥔲=hpszhszhszhhhz
𥕢=hpszhhszhsshszhh
𥖨=hpszhszhszhszhhspd
𥻗=dphspdhspdszhhh
𦈡=zzhhdzsddddhpszss
𦒍=dhdphszhhshhzdhzdh
𦙶=pzdhhsszh
𦝼=pzdhdphspdzph
𦭜=hshsszhpd
𦰡=hshszhhpzs
𧿹=szhshshzzdhd
𨐈=hzhssdphpz
𨙸=hszdzs
𨚕=zdhpszs
𨟠=szhhhszhhhpsdhhhshzs
𨭉=dhpdhhshshzdpdhhsdph
𨱇=phhhzhsdhpdd
𨱏=phhhzhsspdhszh
𨱑=phhhzhsshszhshpd
𨱔=phhhzdphszpzhhhsd
𨺙=zspshzhhpz
𩽾=pzszhshhddzzph
𩾃=pzszhshhpzszhpz
𩾌=pzszhshhdhpzhhsdhpd
