啊=szhzshszhs
阿=zshszhs
埃=hshzdphhpd
挨=hshzdphhpd
哎=szhhsspd
唉=szhzdphhpd
哀=dhszhpzpd
皑=pszhhszszhz
癌=dhpdhszhszhszhszs
蔼=hssdzszhhpzpdz
矮=phhpdphspdzph
艾=hsspd
碍=hpszhszhhhhsd
爱=pddpdzhpzd
隘=zsdphpdszssh
鞍=hsshszhhsddzzph
氨=phhzddzzph
安=ddzzph
俺=pshpdszhhz
按=hshddzzph
暗=szhhdhdphszhh
岸=szshphhs
胺=pzhhddzzph
案=ddzzphhspd
肮=pzhhdhpz
昂=szhhpzzs
盎=szhpdszssh
凹=szszh
敖=hhshzpphpd
熬=hhshzpphpddddd
翱=pszhhhpdhszdhzdh
袄=dzspdphpd
傲=pshhshzpphpd
奥=pszdphspdhpd
懊=ddspszdphspdhpd
澳=ddhpszdphspdhpd
芭=hsszshz
捌=hshszhzpss
扒=hshpd
叭=szhpd
吧=szhzshz
笆=phdphdzshz
八=pd
疤=dhpdhzshz
巴=zshz
拔=hshhpzdd
跋=szhshshhpzdd
靶=hsshszhhszshz
把=hshzshz
耙=hhhspdzshz
坝=hshszpd
霸=hdzsddddhsshszhhspzhh
罢=szsshhshzd
爸=pdpdzshz
白=pszhh
柏=hspdpszhh
百=hpszhh
摆=hshszsshhshzd
佰=pshpszhh
败=szpdphpd
拜=phhphhhhs
稗=phspdpszhhphs
斑=hhshdhpdhhsh
班=hhshdphhsh
搬=hshppzdhdpzzd
扳=hshppzd
般=ppzdhdpzzd
颁=pdzphpszpd
板=hspdppzd
版=pshzppzd
扮=hshpdzp
拌=hshdphhs
伴=psdphhs
瓣=dhdphhpppzdddhdphhs
半=dphhs
办=zpdd
绊=zzhdphhs
邦=hhhpzs
帮=hhhpzsszs
梆=hspdhhhpzs
榜=hspddhdpdzdhzp
膀=pzhhdhdpdzdhzp
绑=zzhhhhpzs
棒=hspdhhhpdhhs
磅=hpszhdhdpdzdhzp
蚌=szhshdhhhs
镑=phhhzdhdpdzdhzp
傍=psdhdpdzdhzp
谤=dzdhdpdzdhzp
苞=hsspzzhz
胞=pzhhpzzhz
包=pzzhz
褒=dhpsszhhspdpzpd
剥=zhhsdhpdss
薄=hssddhhszhhsdhsd
雹=hdzsddddpzzhz
保=psszhhspd
堡=psszhhspdhsh
饱=pzzpzzhz
宝=ddzhhshd
抱=hshpzzhz
报=hshzszd
暴=szhhhsshpdsdhpd
豹=pddpzpppzd
鲍=pzszhshhpzzhz
爆=dppdszhhhsshpdsdhpd
杯=hspdhpsd
碑=hpszhpszhhphs
悲=shhhshhhdzdd
卑=pszhhphs
北=shhpz
辈=shhhshhhhzhs
背=shhpzszhh
贝=szpd
钡=phhhzszpd
倍=psdhdphszh
狈=pzpszpd
备=pzdszhsh
惫=pzdszhshdzdd
焙=dppddhdphszh
被=dzspdzpszd
奔=hpdhshps
苯=hsshspdh
本=hspdh
笨=phdphdhspdh
崩=szspzhhpzhh
绷=zzhpzhhpzhh
甭=hpsdpzhhs
泵=hpszhszpd
蹦=szhshshszspzhhpzhh
迸=dphhpsdzd
逼=hszhszhshdzd
鼻=pszhhhszhshhps
比=hzpz
鄙=szhhsszszhhzs
笔=phdphdphhz
彼=ppszpszd
碧=hhshpszhhhpszh
蓖=hsspszpdhhzpz
蔽=hssdpszspdphpd
毕=hzpzhs
毙=hzpzhpzdpz
毖=hzpzdzdpd
币=pszs
庇=dhphzpz
痹=dhpdhszhshhps
闭=dszhsp
敝=dpszspdphpd
弊=dpszspdphpdhps
必=dzdpd
辟=zhpszhdhdphhs
壁=zhpszhdhdphhshsh
臂=zhpszhdhdphhsszhh
避=zhpszhdhdphhsdzd
陛=zshzpzhsh
鞭=hsshszhhspshszhhpd
边=zpdzd
编=zzhdzhpszhss
贬=szpdpdzd
扁=dzhpszhss
便=pshszhhpd
变=dhsspdzd
卞=dhsd
辨=dhdphhpdpdhdphhs
辩=dhdphhpdzdhdphhs
辫=dhdphhpzzhdhdphhs
遍=dzhpszhssdzd
标=hspdhhspd
彪=shzphzpzppp
膘=pzhhhszsshhhspd
表=hhshpzpd
鳖=dpszspdphpdpzszhshh
憋=dpszspdphpddzdd
别=szhzpss
瘪=dhpdhpszhhhpdpz
彬=hspdhspdppp
斌=dhpdhhshshzd
濒=ddhshshspphpszpd
滨=ddhddzpshshpd
宾=ddzpshshpd
摈=hshddzpshshpd
兵=pshshpd
冰=dhszpd
柄=hspdhszpd
丙=hszpd
秉=phzhhspd
饼=pzzdphhps
炳=dppdhszpd
病=dhpdhhszpd
并=dphhps
玻=hhshzpszd
菠=hssddhzpszd
播=hshpdphspdszhsh
拨=hshzpzdd
钵=phhhzhspdh
波=ddhzpszd
博=hshszhhsdhsd
勃=hsdzzshzp
搏=hshhszhhsdhsd
铂=phhhzpszhh
箔=phdphdddhpszhh
伯=pspszhh
帛=pszhhszs
舶=ppzdhdpszhh
脖=pzhhhsdzzsh
膊=pzhhhszhhsdhsd
渤=ddhhsdzzshzp
泊=ddhpszhh
驳=zzhpdpd
捕=hshhszhhsd
卜=sd
哺=szhhszhhsd
补=dzspdsd
埠=hshpszhzhhs
不=hpsd
布=hpszs
步=shshspp
簿=phdphdddhhszhhsdhsd
部=dhdphszhzs
怖=ddshpszs
擦=hshddzpzddzdhhspd
猜=pzphhshszhh
裁=hshdhpzpdzpd
材=hspdhsp
才=hsp
财=szpdhsp
睬=szhhhpddphspd
踩=szhshshpddphspd
采=pddphspd
彩=pddphspdppp
菜=hsspddphspd
蔡=hsspzddzdhhspd
餐=shpzdzdpddzhhzpd
参=zdhpdppp
蚕=hhpdszhshd
残=hpzdhhzpd
惭=ddshzshpphs
惨=ddszdhpdppp
灿=dppdszs
苍=hsspdzz
舱=ppzdhdpdzz
仓=pdzz
沧=ddhpdzz
藏=hsshpzhphszhszzpd
操=hshszhszhszhhspd
糙=dphspdphshszhdzd
槽=hspdhszhsshszhh
曹=hszhsshszhh
草=hssszhhhs
厕=hpszpdss
策=phdphdhszspd
侧=psszpdss
册=pzpzh
测=ddhszpdss
层=zhphhzd
蹭=szhshshdpszsdphszhh
插=hshphspshzhh
叉=zdd
茬=hsshpshsh
茶=hsspdhspd
查=hspdszhhh
碴=hpszhhspdszhhh
搽=hshhsspdhspd
察=ddzpzddzdhhspd
岔=pdzpszs
差=dphhhphsh
诧=dzddzphz
拆=hshpphsd
柴=shshpzhspd
豺=pddpzpphsp
搀=hshpzszhpzdd
掺=hshzdhpdppp
蝉=szhshddpszhhhs
馋=pzzpzszhpzdd
谗=dzpzszhpzdd
缠=zzhdhpszhhshh
铲=phhhzdhdphp
产=dhdphp
阐=dszdpszhhhs
颤=dhszszhhszhhhhpszpd
昌=szhhszhh
猖=pzpszhhszhh
场=hshzpp
尝=sdpdzhhzd
常=sdpdzszhszs
长=phzd
偿=pssdpdzhhzd
肠=pzhhzpp
厂=hp
敞=sdpszszhphpd
畅=szhhszpp
唱=szhszhhszhh
倡=psszhhszhh
超=hshshpdzpszh
抄=hshspdp
钞=phhhzspdp
朝=hsszhhhspzhh
嘲=szhhsszhhhspzhh
潮=ddhhsszhhhspzhh
巢=zzzszhhhspd
吵=szhspdp
炒=dppdspdp
车=hzhs
扯=hshshsh
撤=hshdhzdszhhphpd
掣=phhszsssphhs
彻=ppshzzp
澈=ddhdhzdszhhphpd
郴=hspdhspdzs
臣=hszhsz
辰=hphhzpd
尘=spdhsh
晨=szhhhphhzpd
忱=ddsdzpz
沉=ddhdzpz
陈=zshzspd
趁=hshshpdpdppp
衬=dzspdhsd
撑=hshsdpdzszhphhs
称=phspdpzspd
城=hshhpzzpd
橙=hspdzdppdhszhdph
成=hpzzpd
呈=szhhhsh
乘=phsshhpzpd
程=phspdszhhhsh
惩=ppshshshdzdd
澄=ddhzdppdhszhdph
诚=dzhpzzpd
承=zshhhzpd
逞=szhhhshdzd
骋=zzhszhshhz
秤=phspdhdphs
吃=szhphz
痴=dhpdhphhpdszh
持=hshhshhsd
匙=szhhhshpdpz
池=ddhzsz
迟=zhpddzd
弛=zhzzsz
驰=zzhzsz
耻=hsshhhshsh
齿=shshpdzs
侈=pspzdpzd
尺=zhpd
赤=hshpspd
翅=hszdzdhzdh
斥=pphsd
炽=dppdszhpd
充=dhzdpz
冲=dhszhs
虫=szhshd
崇=szsddzhhspd
宠=ddzhpzpd
抽=hshszhsh
酬=hszpzhhdpdsds
畴=szhshhhhphsd
踌=szhshshhhhphsd
稠=phspdpzhshszh
愁=phspddppddzdd
筹=phdphdhhhphsd
仇=pspz
绸=zzhpzhshszh
瞅=szhhhphspddppd
丑=zshh
臭=pszhhhhpdd
初=dzspdzp
出=zsszs
橱=hspdhphszhdphhsd
厨=hphszhdphhsd
躇=szhshshhsshshpszhh
锄=phhhzszhhhzp
雏=pzzhhpsdhhhsh
滁=ddhzspdhhspd
除=zspdhhspd
楚=hspdhspdzshpd
础=hpszhzsszs
储=psdzhshpszhh
矗=hsszhhhhhsszhhhhhsszhhhh
搐=hshdhzzdszhsh
触=pzpzhhsszhshd
处=pzdsd
揣=hshszshpszss
川=pss
穿=ddzpdhzsp
椽=hspdzzhpzpppd
传=pshhzd
船=ppzdhdpzszh
喘=szhszshpszss
串=szhszhs
疮=dhpdhpdzz
窗=ddzpdpszpzdh
幢=szsdhdphszhhshh
床=dhphspd
闯=dszzzh
创=pdzzss
吹=szhpzpd
炊=dppdpzpd
捶=hshphshsshh
锤=phhhzphshsshh
垂=phshsshh
春=hhhpdszhh
椿=hspdhhhpdszhh
醇=hszpzhhdhszhzsh
唇=hphhzpdszh
淳=ddhdhszhzsh
纯=zzhhzsz
蠢=hhhpdszhhszhshdszhshd
戳=zdhzdhpsdhhhshhzpd
绰=zzhshszhhhs
疵=dhpdhshshpz
茨=hssdhpzpd
磁=hpszhdphzzdzzd
雌=shshpzpsdhhhsh
辞=phsszhdhdphhs
慈=dphzzdzzddzdd
瓷=dhpzpdhzzd
词=dzzhszh
此=shshpz
刺=hszspdss
赐=szpdszhhpzpp
次=dhpzpd
聪=hsshhhdpszhdzdd
葱=hsspzppddzdd
囱=pszpzdh
匆=pzppd
从=pdpd
丛=pdpdh
凑=dhhhhpdhhpd
粗=dphspdszhhh
醋=hszpzhhhsshszhh
簇=phdphddhzpphphhpd
促=psszhshpd
蹿=szhshshddzpdszhszhs
篡=phdphdszhhhhpdzd
窜=ddzpdszhszhs
摧=hshszspsdhhhsh
崔=szspsdhhhsh
催=psszspsdhhhsh
脆=pzhhpzhpzz
瘁=dhpdhdhpdpdhs
粹=dphspddhpdpdhs
淬=ddhdhpdpdhs
翠=zdhzdhdhpdpdhs
村=hspdhsd
存=hpszsh
寸=hsd
磋=hpszhdphhhphsh
撮=hshszhhhsshhhzd
搓=hshdphhhphsh
措=hshhsshszhh
挫=hshpdpdhsh
错=phhhzhsshszhh
搭=hshhsspdhszh
达=hpddzd
答=phdphdpdhszh
瘩=dhpdhhsspdhszh
打=hshhs
大=hpd
呆=szhhspd
歹=hpzd
傣=pshhhpdsdhpd
戴=hshszhshhsshpdzpd
带=hsssdzszs
殆=hpzdzdszh
代=pshzd
贷=pshzdszpd
袋=pshzddhpzpd
待=ppshshhsd
逮=zhhsdhpddzd
怠=zdszhdzdd
耽=hsshhhdzpz
担=hshszhhh
丹=pzdh
单=dpszhhhs
郸=dpszhhhszs
掸=hshdpszhhhs
胆=pzhhszhhh
旦=szhhh
氮=phhzdppddppd
但=psszhhh
惮=ddsdpszhhhs
淡=ddhdppddppd
诞=dzpshzzd
弹=zhzdpszhhhs
蛋=zshpdszhshd
当=sdpzhh
挡=hshsdpzhh
党=sdpdzszhpz
荡=hssddhzpp
档=hspdsdpzhh
刀=zp
捣=hshpzdzszs
蹈=szhshshpddppshzhh
倒=pshzdhshss
岛=pzdzszs
祷=dzsdhhhphsd
导=zhzhsd
到=hzdhshss
稻=phspdpddppshzhh
悼=ddsshszhhhs
道=dphpszhhhdzd
盗=dhpzpdszssh
德=ppshsszsshhdzdd
得=ppsszhhhhsd
的=pszhhpzd
蹬=szhshshzdppdhszhdph
灯=dppdhs
登=zdppdhszhdph
等=phdphdhshhsd
瞪=szhhhzdppdhszhdph
凳=zdppdhszhdphpz
邓=zdzs
堤=hshszhhhshpd
低=pspzhzd
滴=ddhdhdpszhsszh
迪=szhshdzd
敌=phsszhphpd
笛=phdphdszhsh
狄=pzpdppd
涤=ddhpzdhspd
翟=zdhzdhpsdhhhsh
嫡=zphdhdpszhsszh
抵=hshpzhzd
底=dhppzhzd
地=hshzsz
蒂=hssdhdpdzszs
第=phdphdzhzsp
帝=dhdpdzszs
弟=dpzhzsp
递=dpzhzspdzd
缔=zzhdhdpdzszs
颠=hsszhhhhpdhpszpd
掂=hshdhpshszh
滇=ddhhsszhhhhpd
碘=hpszhszhsshpd
点=shszhdddd
典=szhsshpd
靛=hhshszhhddzhshpd
垫=hshpzdhsh
电=szhhz
佃=psszhsh
甸=pzszhsh
店=dhpshszh
惦=ddsdhpshszh
奠=dphszpzhhhpd
淀=ddhddzhshpd
殿=zhphsshpdpzzd
碉=hpszhpzhshszh
叼=szhzh
雕=pzhshszhpsdhhhsh
凋=dhpzhshszh
刁=zh
掉=hshshszhhhs
吊=szhszs
钓=phhhzpzd
调=dzpzhshszh
跌=szhshshphhpd
爹=pdpdpzdpzd
碟=hpszhhsshzhspd
蝶=szhshdhsshzhspd
迭=phhpddzd
谍=dzhsshzhspd
叠=zdzdzddzszhhh
丁=hs
盯=szhhhhs
叮=szhhs
钉=phhhzhs
顶=hshpszpd
鼎=szhhhzhpshsz
锭=phhhzddzhshpd
定=ddzhshpd
订=dzhs
丢=phshzd
东=hzspd
冬=pzddd
董=hssphszhhshh
懂=ddshssphszhhshh
动=hhzdzp
栋=hspdhzspd
侗=psszhszh
恫=ddsszhszh
冻=dhhzspd
洞=ddhszhszh
兜=pszhhpzzhpz
抖=hshddhs
斗=ddhs
陡=zshshshpd
豆=hszhdph
逗=hszhdphdzd
痘=dhpdhhszhdph
都=hshpszhhzs
督=shhspdzdszhhh
毒=hhshzzdhd
犊=phshhszddhpd
独=pzpszhshd
读=dzhszddhpd
堵=hshhshpszhh
睹=szhhhhshpszhh
赌=szpdhshpszhh
杜=hspdhsh
镀=phhhzdhphsshzd
肚=pzhhhsh
度=dhphsshzd
渡=ddhdhphsshzd
妒=zphdzhp
端=dhdphszshpszss
短=phhpdhszhdph
锻=phhhzpshhhpzzd
段=pshhhpzzd
断=dphspdzpphs
缎=zzhpshhhpzzd
堆=hshpsdhhhsh
兑=dpszhpz
队=zspd
对=zdhsd
墩=hshdhszhzshphpd
吨=szhhzsz
蹲=szhshshdphszpzhhhsd
敦=dhszhzshphpd
顿=hzszhpszpd
囤=szhzszh
钝=phhhzhzsz
盾=pphsszhhh
遁=pphsszhhhdzd
掇=hshzdzdzdzd
哆=szhpzdpzd
多=pzdpzd
夺=hpdhsd
垛=hshpzhspd
躲=pszhhhppzhspd
朵=pzhspd
跺=szhshshpzhspd
舵=ppzdhdddzpz
剁=pzhspdss
惰=ddshphshszhh
堕=zshpszhhhsh
蛾=szhshdphshzpd
峨=szsphshzpd
鹅=phshzpdpzdzh
俄=psphshzpd
额=ddzpzdszhhpszpd
讹=dzpspz
娥=zphphshzpd
恶=hssdphdzdd
厄=hpzz
扼=hshhpzz
遏=szhhpzpdzdzd
鄂=szhszhhhzzs
饿=pzzphshzpd
恩=szhpdhdzdd
而=hpszss
儿=pz
耳=hsshhh
尔=pzspd
饵=pzzhsshhh
洱=ddhhsshhh
二=hh
贰=hhhszpdzd
发=zpzdd
罚=szsshdzss
筏=phdphdpshzpd
伐=pshzpd
乏=pdzd
阀=dszpshzpd
法=ddhhshzd
珐=hhshhshzd
藩=hssddhpdphspdszhsh
帆=szspzd
番=pdphspdszhsh
翻=pdphspdszhshzdhzdh
樊=hspdpdpdhspdhpd
矾=hpszhpzd
钒=phhhzpzd
繁=phzzdhdphpdzzdspd
凡=pzd
烦=dppdhpszpd
反=ppzd
返=ppzddzd
范=hssddhzz
贩=szpdppzd
犯=pzpzz
饭=pzzppzd
泛=ddhpdzd
坊=hshdhzp
芳=hssdhzp
方=dhzp
肪=pzhhdhzp
房=dzhpdhzp
防=zsdhzp
妨=zphdhzp
仿=psdhzp
访=dzdhzp
纺=zzhdhzp
放=dhzpphpd
菲=hssshhhshhh
非=shhhshhh
啡=szhshhhshhh
飞=zpd
肥=pzhhzshz
匪=hshhhshhhz
诽=dzshhhshhh
吠=szhhpdd
肺=pzhhhszs
废=dhpzpzdd
沸=ddhzhzps
费=zhzpsszpd
芬=hsspdzp
酚=hszpzhhpdzp
吩=szhpdzp
氛=phhzpdzp
分=pdzp
纷=zzhpdzp
坟=hshdhpd
焚=hspdhspddppd
汾=ddhpdzp
粉=dphspdpdzp
奋=hpdszhsh
份=pspdzp
忿=pdzpdzdd
愤=ddshshssszpd
粪=dphspdhsshpd
丰=hhhs
封=hshhshhsd
枫=hspdpzpd
蜂=szhshdpzdhhhs
峰=szspzdhhhs
锋=phhhzpzdhhhs
风=pzpd
疯=dhpdhpzpd
烽=dppdpzdhhhs
逢=pzdhhhsdzd
冯=dhzzh
缝=zzhpzdhhhsdzd
讽=dzpzpd
奉=hhhpdhhs
凤=pzzd
佛=pszhzps
否=hpsdszh
夫=hhpd
敷=hszhhsddhzpphpd
肤=pzhhhhpd
孵=pzdpzsdpddpzsh
扶=hshhhpd
拂=hshzhzps
辐=hzshhszhszhsh
幅=szshszhszhsh
氟=phhzzhzps
符=phdphdpshsd
伏=pshpdd
俘=pspddpzsh
服=pzhhzszd
浮=ddhpddpzsh
涪=ddhdhdphszh
福=dzsdhszhszhsh
袱=dzspdpshpdd
弗=zhzps
甫=hszhhsd
抚=hshhhpz
辅=hzshhszhhsd
俯=psdhppshsd
釜=pdpdhhsdph
斧=pdpdpphs
脯=pzhhhszhhsd
腑=pzhhdhppshsd
府=dhppshsd
腐=dhppshsdszpdpd
赴=hshshpdsd
副=hszhszhshss
覆=hszsshppsphszhhpzd
赋=szpdhhshshzd
复=phszhhpzd
傅=pshszhhsdhsd
付=pshsd
阜=pszhzhhs
父=pdpd
腹=pzhhphszhhpzd
负=pzszpd
富=ddzhszhszhsh
讣=dzsd
附=zspshsd
妇=zphzhh
缚=zzhhszhhsdhsd
咐=szhpshsd
噶=szhhssszhhpzpdz
嘎=szhhpszhhhhzpd
该=dzdhzppd
改=zhzphpd
概=hspdzhhzdhzpz
钙=phhhzhshz
盖=dphhshszssh
溉=ddhzhhzdhzpz
干=hhs
甘=hsshh
杆=hspdhhs
柑=hspdhsshh
竿=phdphdhhs
肝=pzhhhhs
赶=hshshpdhhs
感=hphszhzpddzdd
秆=phspdhhs
敢=zhsshhhphpd
赣=dhdphszhhhspzdhshszpd
冈=szpd
刚=szpdss
钢=phhhzszpd
缸=phhszshsh
肛=pzhhhsh
纲=zzhszpd
岗=szsszpd
港=ddhhsshpdzhz
杠=hspdhsh
篙=phdphddhszhszszh
皋=pszhhhpdhs
高=dhszhszszh
膏=dhszhdzszhszhh
羔=dphhshdddd
糕=dphspddphhshdddd
搞=hshdhszhszszh
镐=phhhzdhszhszszh
稿=phspddhszhszszh
告=phshszh
哥=hszhshszhs
歌=hszhshszhspzpd
搁=hshdszpzdszh
戈=hzpd
鸽=pdhszhpzdzh
胳=pzhhpzdszh
疙=dhpdhphz
割=ddzhhhsszhss
革=hsshszhhs
葛=hssszhhpzpdz
格=hspdpzdszh
蛤=szhshdpdhszh
阁=dszpzdszh
隔=zshszhszdphs
铬=phhhzpzdszh
个=pds
各=pzdszh
给=zzhpdhszh
根=hspdzhhzpd
跟=szhshshzhhzpd
耕=hhhspdhhps
更=hszhhpd
庚=dhpzhhpd
羹=dphhshdddddphhshhpd
埂=hshhszhhpd
耿=hsshhhdppd
梗=hspdhszhhpd
工=hsh
攻=hshphpd
功=hshzp
恭=hsshpdsddd
龚=hpzpdhsshpd
供=pshsshpd
躬=pszhhhpzhz
公=pdzd
宫=ddzszhszh
弓=zhz
巩=hshpzd
汞=hshszpd
拱=hshhsshpd
贡=hshszpd
共=hsshpd
钩=phhhzpzzd
勾=pzzd
沟=ddhpzzd
苟=hsspzszh
狗=pzppzszh
垢=hshpphszh
构=hspdpzzd
购=szpdpzzd
够=pzszhpzdpzd
辜=hsszhdhdphhs
菇=hsszphhsszh
咕=szhhsszh
箍=phdphdhshhszsz
估=pshsszh
沽=ddhhsszh
孤=zshppzdd
姑=zphhsszh
鼓=hshszhdphhszd
古=hsszh
蛊=szhshdszssh
骨=szzdzszhh
谷=pdpdszh
股=pzhhpzzd
故=hsszhphpd
顾=hpzzhpszpd
固=szhsszhh
雇=dzhppsdhhhsh
刮=phsszhss
瓜=ppzdd
剐=szhszpdss
寡=ddzhpszhhhpdzp
挂=hshhshhsh
褂=dzspdhshhshsd
乖=phsshhpz
拐=hshszhzp
怪=ddszdhsh
棺=hspdddzszhzh
关=dphhpd
官=ddzszhzh
冠=dzhhpzhsd
观=zdszpz
管=phdphdddzszhzh
馆=pzzddzszhzh
罐=phhszshssszhszhpsdhhhsh
惯=ddszzshszpd
灌=ddhhssszhszhpsdhhhsh
贯=zzshszpd
光=sdphpz
广=dhp
逛=pzphhshdzd
瑰=hhshpszhhpzzd
规=hhpdszpz
圭=hshhsh
硅=hpszhhshhsh
归=spzhh
龟=pzszhhz
闺=dszhshhsh
轨=hzshpz
鬼=pszhhpzzd
诡=dzpzhpzz
癸=zdppdhhpd
桂=hspdhshhsh
柜=hspdhzhz
跪=szhshshpzhpzz
贵=szhshszpd
刽=pdhhzdss
辊=hzshszhhhzpz
滚=ddhdhpdzdpzpd
棍=hspdszhhhzpz
锅=phhhzszhszpd
郭=dhszhzshzs
国=szhhshdh
果=szhhhspd
裹=dhszhhhspdpzpd
过=hsddzd
哈=szhpdhszh
骸=szzdzszhhdhzppd
孩=zshdhzppd
海=ddhphzzdhd
氦=phhzdhzppd
亥=dhzppd
害=ddzhhhsszh
骇=zzhdhzppd
酣=hszpzhhhsshh
憨=zhsshhhphpddzdd
邯=hsshhzs
韩=hsszhhhshhzs
含=pddzszh
涵=ddhzsdhpdzs
寒=ddzhhsshpddd
函=zsdhpdzs
喊=szhhphszhzpd
罕=dzpdhhs
翰=hsszhhhspdzdhzdh
撼=hshhphszhzpddzdd
捍=hshszhhhhs
旱=szhhhhs
憾=ddshphszhzpddzdd
悍=ddsszhhhhs
焊=dppdszhhhhs
汗=ddhhhs
汉=ddhzd
夯=hpdzp
杭=hspddhpz
航=ppzdhddhpz
壕=hshdhszhdzhpzpppd
嚎=szhdhszhdzhpzpppd
豪=dhszhdzhpzpppd
毫=dhszhdzphhz
郝=hshpspdzs
好=zphzsh
耗=hhhspdphhz
号=szhhz
浩=ddhphshszh
呵=szhhszhs
喝=szhszhhpzpdz
荷=hsspshszhs
菏=hssddhhszhs
核=hspddhzppd
禾=phspd
和=phspdszh
何=pshszhs
合=pdhszh
盒=pdhszhszssh
貉=pddpzpppzdszh
阂=dszdhzppd
河=ddhhszhs
涸=ddhszhsszhh
赫=hshpspdhshpspd
褐=dzspdszhhpzpdz
鹤=dzpsdhhhshpzdzh
贺=zpszhszpd
嘿=szhszdphshhdddd
黑=szdphshhdddd
痕=dhpdhzhhzpd
很=ppszhhzpd
狠=pzpzhhzpd
恨=ddszhhzpd
哼=szhdhszhzs
亨=dhszhzs
横=hspdhsshszhshpd
衡=ppspzszhshhpdhhs
恒=ddshszhhh
轰=hzhszdzd
哄=szhhsshpd
烘=dppdhsshpd
虹=szhshdhsh
鸿=ddhhshpzdzh
洪=ddhhsshpd
宏=ddzhpzd
弘=zhzzd
红=zzhhsh
喉=szhpszhphhpd
侯=pszhphhpd
猴=pzppszhphhpd
吼=szhzshz
厚=hpszhhzsh
候=psszhphhpd
后=pphszh
呼=szhpdphs
乎=pdphs
忽=pzppdzdd
瑚=hhshhsszhpzhh
壶=hshdzssdph
葫=hsshsszhpzhh
胡=hsszhpzhh
蝴=szhshdhsszhpzhh
狐=pzpppzdd
糊=dphspdhsszhpzhh
湖=ddhhsszhpzhh
弧=zhzppzdd
虎=shzphzpz
唬=szhshzphzpz
护=hshdzhp
互=hzzh
沪=ddhdzhp
户=dzhp
花=hsspspz
哗=szhpspzhs
华=pspzhs
猾=pzpszzdzszhh
滑=ddhszzdzszhh
画=hszhshzs
划=hzpdss
化=pspz
话=dzphsszh
槐=hspdpszhhpzzd
徊=ppsszszhh
怀=ddshpsd
淮=ddhpsdhhhsh
坏=hshhpsd
欢=zdpzpd
环=hhshhpsd
桓=hspdhszhhh
还=hpsddzd
缓=zzhpddphhpzd
换=hshpzszhpd
患=szhszhsdzdd
唤=szhpzszhpd
痪=dhpdhpzszhpd
豢=dphhpdhpzpppd
焕=dppdpzszhpd
涣=ddhpzszhpd
宦=ddzhszhsz
幻=zzdz
荒=hssdhzpsz
慌=ddshssdhzpsz
黄=hsshszhshpd
磺=hpszhhsshszhshpd
蝗=szhshdpszhhhhsh
簧=phdphdhsshszhshpd
皇=pszhhhhsh
凰=pzpszhhhhsh
惶=ddspszhhhhsh
煌=dppdpszhhhhsh
晃=szhhsdphpz
幌=szsszhhsdphpz
恍=ddssdphpz
谎=dzhssdhzpsz
灰=hpdppd
挥=hshdzhzhs
辉=sdphpzdzhzhs
徽=ppsszshzzdspdphpd
恢=ddshpdppd
蛔=szhshdszszhh
回=szszhh
毁=pshzhhhshpzzd
悔=ddsphzzdhd
慧=hhhshhhszhhdzdd
卉=hshps
惠=hszhhshddzdd
晦=szhhphzzdhd
贿=szpdhpszhh
秽=phspdszspzd
会=pdhhzd
烩=dppdpdhhzd
汇=ddhhz
讳=dzhhzs
诲=dzphzzdhd
绘=zzhpdhhzd
荤=hssdzhzhs
昏=pzhzszhh
婚=zphpzhzszhh
魂=hhzdpszhhpzzd
浑=ddhdzhzhs
混=ddhszhhhzpz
豁=ddzhhhsszhpdpdszh
活=ddhphsszh
伙=psdppd
火=dppd
获=hsspzphpdd
或=hszhhzpd
惑=hszhhzpddzdd
霍=hdzsddddpsdhhhsh
货=pspzszpd
祸=dzsdszhszpd
击=hhszs
圾=hshpzd
基=hsshhhpdhsh
机=hspdpz
畸=szhshhpdhszhs
稽=phspdhpzdpzszhh
积=phspdszhpd
箕=phdphdhsshhhpd
肌=pzhhpz
饥=pzzpz
迹=dhpspddzd
激=ddhpszhhdhzpphpd
讥=dzpz
鸡=zdpzdzh
姬=zphhsszhsz
绩=zzhhhshszpd
缉=zzhszhhsshhh
吉=hshszh
极=hspdpzd
棘=hszspdhszspd
辑=hzshszhhsshhh
籍=phdphdhhhspdhsshszhh
集=psdhhhshhspd
及=pzd
急=pzzhhdzdd
疾=dhpdhphhpd
汲=ddhpzd
即=zhhzdzs
嫉=zphdhpdhphhpd
级=zzhpzd
挤=hshdhpdps
几=pz
脊=dhpdpdszhh
己=zhz
蓟=hsspzszhshhss
技=hshhszd
冀=shhpzszhshhsshpd
季=phspdzsh
伎=pshszd
祭=pzddzdhhspd
剂=dhpdpsss
悸=ddsphspdzsh
济=ddhdhpdps
寄=ddzhpdhszhs
寂=ddzshhspdzd
计=dzhs
记=dzzhz
既=zhhzdhzpz
忌=zhzdzdd
际=zshhspd
妓=zphhszd
继=zzhdphspdz
纪=zzhzhz
嘉=hshszhdphzpszh
枷=hspdzpszh
夹=hdphpd
佳=pshshhsh
家=ddzhpzpppd
加=zpszh
荚=hsshdphpd
颊=hdphpdhpszpd
贾=hszsshszpd
甲=szhhs
钾=phhhzszhhs
假=pszhshhzhzd
稼=phspdddzhpzpppd
价=pspdps
架=zpszhhspd
驾=zpszhzzh
嫁=zphddzhpzpppd
歼=hpzdphs
监=ssphdszssh
坚=sszdhsh
尖=spdhpd
笺=phdphdhhzpd
间=dszszhh
煎=dphszhhssdddd
兼=dphzhhsspd
肩=dzhpszhh
艰=zdzhhzpd
奸=zphhhs
缄=zzhhphszhzpd
茧=hssszhshd
检=hspdpdhddph
柬=hszdphspd
碱=hpszhhphszhzpd
硷=hpszhpdhddph
拣=hshhzzpd
捡=hshpdhddph
简=phdphddszszhh
俭=pspdhddph
剪=dphszhhsszp
减=dhhphszhzpd
荐=hsshpszsh
槛=hspdssphdszssh
鉴=ssphdpdhhsdph
践=szhshshhhzpd
贱=szpdhhzpd
见=szpz
键=phhhzzhhhhszd
箭=phdphddphszhhss
件=psphhs
健=pszhhhhszd
舰=ppzdhdszpz
剑=pdhddphss
饯=pzzhhzpd
渐=ddhhzshpphs
溅=ddhszpdhhzpd
涧=ddhdszszhh
建=zhhhhszd
僵=pshszhshhszhshh
姜=dphhshzph
将=dhspzdhsd
浆=dhspzdszpd
江=ddhhsh
疆=zhzhshhszhshhszhshh
蒋=hssdhspzdhsd
桨=dhspzdhspd
奖=dhspzdhpd
讲=dzhhps
匠=hpphsz
酱=dhspzdhszpzhh
降=zspzdhzs
蕉=hsspsdhhhshdddd
椒=hspdshhspdzd
礁=hpszhpsdhhhshdddd
焦=psdhhhshdddd
胶=pzhhdhpdpd
交=dhpdpd
郊=dhpdpdzs
浇=ddhhzphpz
骄=zzhphpdps
娇=zphphpdps
嚼=szhpddpszsshzhhzdhsd
搅=hshddpdzszpz
铰=phhhzdhpdpd
矫=phhpdphpdps
侥=pshzphpz
脚=pzhhhshzdzs
狡=pzpdhpdpd
角=pzpzhhs
饺=pzzdhpdpd
缴=zzhpszhhdhzpphpd
绞=zzhdhpdpd
剿=zzzhzhhhspdss
教=hshpzshphpd
酵=hszpzhhhshpzsh
轿=hzshphpdps
较=hzshdhpdpd
叫=szhzs
窖=ddzpdphshszh
揭=hshszhhpzpdz
接=hshdhdphzph
皆=hzpzpszhh
秸=phspdhshszh
街=ppshshhshhhs
阶=zspdps
截=hshpsdhhhshzpd
劫=hshzdzp
节=hsszs
桔=hspdhshszh
杰=hspddddd
捷=hshhzhhshpd
睫=szhhhhzhhshpd
竭=dhdphszhhpzpdz
洁=ddhhshszh
结=zzhhshszh
解=pzpzhhszpphhs
姐=zphszhhh
戒=hhpszpd
藉=hsshhhspdhsshszhh
芥=hsspdps
界=szhshpdps
借=pshsshszhh
介=pdps
疥=dhpdhpdps
诫=dzhhpszpd
届=zhpszhsh
巾=szs
筋=phdphdpzhhzp
斤=pphs
金=pdhhsdph
今=pddz
津=ddhzhhhhs
襟=dzspdhspdhspdhhspd
紧=sszdzzdspd
锦=phhhzpszhhszs
仅=pszd
谨=dzhsshszhhhsh
进=hhpsdzd
靳=hsshszhhspphs
晋=hssdphszhh
禁=hspdhspdhhspd
近=pphsdzd
烬=dppdzhpddd
浸=ddhzhhdzzd
尽=zhpddd
劲=zdhshzp
荆=hsshhpsss
兢=hsszhpzhsszhpz
茎=hsszdhsh
睛=szhhhhhshszhh
晶=szhhszhhszhh
鲸=pzszhshhdhszhspd
京=dhszhspd
惊=ddsdhszhspd
精=dphspdhhshszhh
粳=dphspdhszhhpd
经=zzhzdhsh
井=hhps
警=hsspzszhphpddhhhszh
景=szhhdhszhspd
颈=zdhshhpszpd
静=hhshszhhpzzhhs
境=hshdhdphszhhpz
敬=hsspzszhphpd
镜=phhhzdhdphszhhpz
径=ppszdhsh
痉=dhpdhzdhsh
靖=dhdphhhshszhh
竟=dhdphszhhpz
竞=dhdphszhpz
净=dhpzzhhs
炯=dppdszszh
窘=ddzpdzhhpszh
揪=hshphspddppd
究=ddzpdpz
纠=zzhzs
玖=hhshpzd
韭=shhhshhhh
久=pzd
灸=pzddppd
九=pz
酒=ddhhszpzhh
厩=hpzhhzdhzpz
救=hsdhpddphpd
旧=sszhh
臼=pshzhh
舅=pshzhhszhshzp
咎=pzdsdszh
就=dhszhspdhpzd
疚=dhpdhpzd
鞠=hsshszhhspzdphspd
拘=hshpzszh
狙=pzpszhhh
疽=dhpdhszhhh
居=zhphsszh
驹=zzhpzszh
菊=hsspzdphspd
局=zhpzszh
咀=szhszhhh
矩=phhpdhzhz
举=ddphpdhhs
沮=ddhszhhh
聚=hsshhhzdpspppd
拒=hshhzhz
据=hshzhphsszh
巨=hzhz
具=szhhhhpd
距=szhshshhzhz
踞=szhshshzhphsszh
锯=phhhzzhphsszh
俱=psszhhhhpd
句=pzszh
惧=ddsszhhhhpd
炬=dppdhzhz
剧=zhphsszhss
捐=hshszhszhh
鹃=szhszhhpzdzh
娟=zphszhszhh
倦=psdphhpdzz
眷=dphhpdszhhh
卷=dphhpdzz
绢=zzhszhszhh
撅=hshhpdphzsppzpd
攫=hshszhhhszhhhpsdhhhshzd
抉=hshzhpd
掘=hshzhpzsszs
倔=pszhpzsszs
爵=pddpszsshzhhzdhsd
觉=ddpdzszpz
决=dhzhpd
诀=dzzhpd
绝=zzhpzzshz
均=hshpzdh
菌=hssszphspdh
钧=phhhzpzdh
军=dzhzhs
君=zhhpszh
峻=szszdpdpzd
俊=pszdpdpzd
竣=dhdphzdpdpzd
浚=ddhzdpdpzd
郡=zhhpszhzs
骏=zzhzdpdpzd
喀=szhddzpzdszh
咖=szhzpszh
卡=shhsd
咯=szhpzdszh
开=hhps
揩=hshhzpzpszhh
楷=hspdhzpzpszhh
凯=szszhzpz
慨=ddszhhzdhzpz
刊=hhsss
堪=hshhsshhhpdz
勘=hsshhhpdzzp
坎=hshpzpd
砍=hpszhpzpd
看=phhpszhhh
康=dhpzhhsdhpd
慷=ddsdhpzhhsdhpd
糠=dphspddhpzhhsdhpd
扛=hshhsh
抗=hshdhpz
亢=dhpz
炕=dppddhpz
考=hshphz
拷=hshhshphz
烤=dppdhshphz
靠=phshszhshhhshhh
坷=hshhszhs
苛=hsshszhs
柯=hspdhszhs
棵=hspdszhhhspd
磕=hpszhhshzdszssh
颗=szhhhspdhpszpd
科=phspdddhs
壳=hshdzpz
咳=szhdhzppd
可=hszhs
渴=ddhszhhpzpdz
克=hsszhpz
刻=dhzppdss
客=ddzpzdszh
课=dzszhhhspd
肯=shshszhh
啃=szhshshszhh
垦=zhhzpdhsh
恳=zhhzpddzdd
坑=hshdhpz
吭=szhdhpz
空=ddzpdhsh
恐=hshpzddzdd
孔=zshz
控=hshddzpdhsh
抠=hshhpdz
口=szh
扣=hshszh
寇=ddzhhpzshzd
枯=hspdhsszh
哭=szhszhhpdd
窟=ddzpdzhpzsszs
苦=hsshsszh
酷=hszpzhhphshszh
库=dhphzhs
裤=dzspddhphzhs
夸=hpdhhz
垮=hshhpdhhz
挎=hshhpdhhz
跨=szhshshhpdhhz
胯=pzhhhpdhhz
块=hshzhpd
筷=phdphdddszhpd
侩=pspdhhzd
快=ddszhpd
宽=ddzhssszpz
款=hshhhspdpzpd
匡=hhhshz
筐=phdphdhhhshz
狂=pzphhsh
框=hspdhhhshz
矿=hpszhdhp
眶=szhhhhhhshz
旷=szhhdhp
况=dhszhpz
亏=hhz
盔=hpdppdszssh
岿=szsspzhh
窥=ddzpdhhpdszpz
葵=hsszdppdhhpd
奎=hpdhshhsh
魁=pszhhpzzdddhs
傀=pspszhhpzzd
馈=pzzszhshszpd
愧=ddspszhhpzzd
溃=ddhszhshszpd
坤=hshszhhs
昆=szhhhzpz
捆=hshszhspdh
困=szhspdh
括=hshphsszh
扩=hshdhp
廓=dhpdhszhzshzs
阔=dszddhphsszh
垃=hshdhdph
拉=hshdhdph
喇=szhhszhspdss
蜡=szhshdhsshszhh
腊=pzhhhsshszhh
辣=dhdphhphszhspd
啦=szhhshdhdph
莱=hsshdphspd
来=hdphspd
赖=hszhspdpzszpd
蓝=hssssphdszssh
婪=hspdhspdzph
栏=hspddphhh
拦=hshdphhh
篮=phdphdssphdszssh
阑=dszhszdphspd
兰=dphhh
澜=ddhdszhszdphspd
谰=dzdszhszdphspd
揽=hshssphdszpz
览=ssphdszpz
懒=ddshszhspdpzszpd
缆=zzhssphdszpz
烂=dppddphhh
滥=ddhssphdszssh
琅=hhshdzhhzpd
榔=hspddzhhzdzs
狼=pzpdzhhzpd
廊=dhpdzhhzdzs
郎=dzhhzdzs
朗=dzhhzdpzhh
浪=ddhdzhhzpd
捞=hshhssdzzp
劳=hssdzzp
牢=ddzphhs
老=hshppz
佬=pshshppz
姥=zphhshppz
酪=hszpzhhpzdszh
烙=dppdpzdszh
涝=ddhhssdzzp
勒=hsshszhhszp
乐=pzspd
雷=hdzsddddszhsh
镭=phhhzhdzsddddszhsh
蕾=hsshdzsddddszhsh
磊=hpszhhpszhhpszh
累=szhshzzdspd
儡=psszhshszhshszhsh
垒=zdzdzdhsh
擂=hshhdzsddddszhsh
肋=pzhhzp
类=dphspdhpd
泪=ddhszhhh
棱=hspdhshpdpzd
楞=hspdszsshdhzp
冷=dhpddzd
厘=hpszhhshh
梨=phspdsshspd
犁=phspdssphhs
黎=phspdpzppdsdhpd
篱=phdphddhpdzsszzd
狸=pzpszhhshh
离=dhpdzsszzd
漓=ddhdhpdzsszzd
理=hhshszhhshh
李=hspdzsh
里=szhhshh
鲤=pzszhshhszhhshh
礼=dzsdz
莉=hssphspdss
荔=hsszpzpzp
吏=hszhpd
栗=hszsshhspd
丽=hszdszd
厉=hphzp
励=hphzpzp
砾=hpszhpzspd
历=hpzp
利=phspdss
傈=pshszsshhspd
例=pshpzdss
俐=psphspdss
痢=dhpdhphspdss
立=dhdph
粒=dphspddhdph
沥=ddhhpzp
隶=zhhsdhpd
力=zp
璃=hhshdhpdzsszzd
哩=szhszhhshh
俩=pshszpdpd
联=hsshhhdphhpd
莲=hsshzhsdzd
连=hzhsdzd
镰=phhhzdhpdphzhhsspd
廉=dhpdphzhhsspd
怜=ddspddzd
涟=ddhhzhsdzd
帘=ddzpdszs
敛=pdhddphphpd
脸=pzhhpdhddph
链=phhhzhzhsdzd
恋=dhsspddzdd
炼=dppdhzzpd
练=zzhhzzpd
粮=dphspddzhhzpd
凉=dhdhszhspd
梁=ddhzpddhspd
粱=ddhzpdddphspd
良=dzhhzpd
两=hszpdpd
辆=hzshhszpdpd
量=szhhhszhhshh
晾=szhhdhszhspd
亮=dhszhdzpz
谅=dzdhszhspd
撩=hshhpddpszhhspd
聊=hsshhhpzpzs
僚=pshpddpszhhspd
疗=dhpdhzs
燎=dppdhpddpszhhspd
寥=ddzzdhzdhpdppp
辽=zsdzd
潦=ddhhpddpszhhspd
了=zs
撂=hshszhshpzdszh
镣=phhhzhpddpszhhspd
廖=dhpzdhzdhpdppp
料=dphspdddhs
列=hpzdss
裂=hpzdssdhpzpd
烈=hpzdssdddd
劣=spdpzp
猎=pzphsshszhh
琳=hhshhspdhspd
林=hspdhspd
磷=hpszhdphspdpzdhzs
霖=hdzsddddhspdhspd
临=ssphdszsh
邻=pddzdzs
鳞=pzszhshhdphspdpzdhzs
淋=ddhhspdhspd
凛=dhdhszszhhhhspd
赁=psphshszpd
吝=dhpdszh
拎=hshpddzd
玲=hhshpddzd
菱=hsshshpdpzd
零=hdzsddddpddzd
龄=shshpdzspddzd
铃=phhhzpddzd
伶=pspddzd
羚=dphhhppddzd
凌=dhhshpdpzd
灵=zhhdppd
陵=zshshpdpzd
岭=szspddzd
领=pddzdhpszpd
另=szhzp
令=pddzd
溜=ddhpzdzpszhsh
琉=hhshdhzdpsz
榴=hspdpzdzpszhsh
硫=hpszhdhzdpsz
馏=pzzpzdzpszhsh
留=pzdzpszhsh
刘=dhpdss
瘤=dhpdhpzdzpszhsh
流=ddhdhzdpsz
柳=hspdpzpzs
六=dhpd
龙=hpzpd
聋=hpzpdhsshhh
咙=szhhpzpd
笼=phdphdhpzpd
窿=ddzpdzspzdhphhsh
隆=zspzdhphhsh
垄=hpzpdhsh
拢=hshhpzpd
陇=zshpzpd
楼=hspddphspdzph
娄=dphspdzph
搂=hshdphspdzph
篓=phdphddphspdzph
漏=ddhzhphszsdddd
陋=zshszpdz
芦=hssdzhp
卢=shzhp
颅=shzhphpszpd
庐=dhpdzhp
炉=dppddzhp
掳=hshshzphzzp
卤=shszpdh
虏=shzphzzp
鲁=pzszhshhszhh
麓=hspdhspddhpzsshhzpz
碌=hpszhzhhsdhpd
露=hdzsddddszhshshpzdszh
路=szhshshpzdszh
赂=szpdpzdszh
鹿=dhpzsshhzpz
潞=ddhszhshshpzdszh
禄=dzsdzhhsdhpd
录=zhhsdhpd
陆=zshhszs
戮=zdhzdhpdppphzpd
驴=zzhdzhp
吕=szhszh
铝=phhhzszhszh
侣=psszhszh
旅=dhzpphpzpd
履=zhpppsphszhhpzd
屡=zhpdphspdzph
缕=zzhdphspdzph
虑=shzphzdzdd
氯=phhzzhhsdhpd
律=ppszhhhhs
率=dhzzddhpdhs
滤=ddhshzphzdzdd
绿=zzhzhhsdhpd
峦=dhsspdszs
挛=dhsspdphhs
孪=dhsspdzsh
滦=ddhdhsspdhspd
卵=pzdpzsd
乱=phsszhz
掠=hshdhszhspd
略=szhshpzdszh
抡=hshpdpz
轮=hzshpdpz
伦=pspdpz
仑=pdpz
沦=ddhpdpz
纶=zzhpdpz
论=dzpdpz
萝=hssszsshpzd
螺=szhshdszhshzzdspd
罗=szsshpzd
逻=szsshpzddzd
锣=phhhzszsshpzd
箩=phdphdszsshpzd
骡=zzhszhshzzdspd
裸=dzspdszhhhspd
落=hssddhpzdszh
洛=ddhpzdszh
骆=zzhpzdszh
络=zzhpzdszh
妈=zphzzh
麻=dhphspdhspd
玛=hhshzzh
码=hpszhzzh
蚂=szhshdzzh
马=zzh
骂=szhszhzzh
嘛=szhdhphspdhspd
吗=szhzzh
埋=hshszhhshh
买=zddhpd
麦=hhshpzd
卖=hszddhpd
迈=hzpdzd
脉=pzhhdzzpd
瞒=szhhhhsshszpdpd
馒=pzzszhhszsshzd
蛮=dhsspdszhshd
满=ddhhsshszpdpd
蔓=hssszhhszsshzd
曼=szhhszsshzd
慢=ddsszhhszsshzd
漫=ddhszhhszsshzd
谩=dzszhhszsshzd
芒=hssdhz
茫=hssddhdhz
盲=dhzszhhh
氓=dhzzhzhz
忙=ddsdhz
莽=hsshpddhps
猫=pzphssszhsh
茅=hsszdzsp
锚=phhhzhssszhsh
毛=phhz
矛=zdzsp
铆=phhhzpzpzh
卯=pzpzs
茂=hsshpzpd
冒=szhhszhhh
帽=szsszhhszhhh
貌=pddpzpppszhhpz
贸=pzdzpszpd
么=pzd
玫=hhshphpd
枚=hspdphpd
梅=hspdphzzdhd
酶=hszpzhhphzzdhd
霉=hdzsddddphzzdhd
煤=dppdhsshhhspd
没=ddhpzzd
眉=zshpszhhh
媒=zphhsshhhspd
镁=phhhzdphhshhpd
每=phzzdhd
美=dphhshhpd
昧=szhhhhspd
寐=ddzzshphhspd
妹=zphhhspd
媚=zphzshpszhhh
门=dsz
闷=dszdzdd
们=psdsz
萌=hssszhhpzhh
蒙=hssdzhhpzpppd
檬=hspdhssdzhhpzpppd
盟=szhhpzhhszssh
锰=phhhzzshszssh
猛=pzpzshszssh
梦=hspdhspdpzd
孟=zshszssh
眯=szhhhdphspd
醚=hszpzhhdphspddzd
靡=dhphspdhspdshhhshhh
糜=dhphspdhspddphspd
迷=dphspddzd
谜=dzdphspddzd
弥=zhzpzspd
米=dphspd
秘=phspddzdpd
觅=pddpszpz
泌=ddhdzdpd
蜜=ddzdzdpdszhshd
密=ddzdzdpdszs
幂=dzszhhhpdszs
棉=hspdpszhhszs
眠=szhhhzhzhz
绵=zzhpszhhszs
冕=szhhpzszhpz
免=pzszhpz
勉=pzszhpzzp
娩=zphpzszhpz
缅=zzhhpszsshhh
面=hpszsshhh
苗=hssszhsh
描=hshhssszhsh
瞄=szhhhhssszhsh
藐=hsspddpzpppszhhpz
秒=phspdspdp
渺=ddhszhhhspdp
庙=dhpszhsh
妙=zphspdp
蔑=hssszsshhpdzpd
灭=hdppd
民=zhzhz
抿=hshzhzhz
皿=szssh
敏=phzzdhdphpd
悯=ddsdszdhpd
闽=dszszhshd
明=szhhpzhh
螟=szhshddzszhhdhpd
鸣=szhpzdzh
铭=phhhzpzdszh
名=pzdszh
命=pdhszhzs
谬=dzzdhzdhpdppp
摸=hshhssszhhhpd
摹=hssszhhhpdphhs
蘑=hssdhphspdhspdhpszh
模=hspdhssszhhhpd
膜=pzhhhssszhhhpd
磨=dhphspdhspdhpszh
摩=dhphspdhspdphhs
魔=dhphspdhspdpszhhpzzd
抹=hshhhspd
末=hhspd
莫=hssszhhhpd
墨=szdphshhddddhsh
默=szdphshhddddhpdd
沫=ddhhhspd
漠=ddhhssszhhhpd
寞=ddzhssszhhhpd
陌=zshpszhh
谋=dzhsshhhspd
牟=zdphhs
某=hsshhhspd
拇=hshzzdhd
牡=phshhsh
亩=dhszhsh
姆=zphzzdhd
母=zzdhd
墓=hssszhhhpdhsh
暮=hssszhhhpdszhh
幕=hssszhhhpdszs
募=hssszhhhpdzp
慕=hssszhhhpdsddd
木=hspd
目=szhhh
睦=szhhhhshpdhsh
牧=phshphpd
穆=phspdpszhhspdppp
拿=pdhszhphhs
哪=szhzhhpzs
呐=szhszpd
钠=phhhzszpd
那=zhhpzs
娜=zphzhhpzs
纳=zzhszpd
氖=phhzzp
乃=zp
奶=zphzp
耐=hpszsshsd
奈=hpdhhspd
南=hsszdphhs
男=szhshzp
难=zdpsdhhhsh
囊=hszhsdzszhszhhhsshpzsd
挠=hshhzphpz
脑=pzhhdhpdzs
恼=ddsdhpdzs
闹=dszdhszs
淖=ddhshszhhhs
呢=szhzhppz
馁=pzzpddpzph
内=szpd
嫩=zphhszhspdphpd
能=zdszhhpzpz
妮=zphzhppz
霓=hdzsddddpshzhhpz
倪=pspshzhhpz
泥=ddhzhppz
尼=zhppz
拟=hshzdpd
你=pspzspd
匿=hhsshpszhz
腻=pzhhhhhszpdzd
逆=dphzspdzd
溺=ddhzhzdhzhzdh
蔫=hsshshshhzdddd
拈=hshshszh
年=phhshs
碾=hpszhzhphsshzpd
撵=hshhhpdhhpdhzhs
捻=hshpddzdzdd
念=pddzdzdd
娘=zphdzhhzpd
酿=hszpzhhdzhhzpd
鸟=pzdzh
尿=zhpszpd
捏=hshszhhhsh
聂=hsshhhzdzd
孽=hsspszhzhdhdphhszsh
啮=szhshshpdzs
镊=phhhzhsshhhzdzd
镍=phhhzpszhhhhspd
涅=ddhszhhhsh
您=pspzspddzdd
柠=hspdddzhs
狞=pzpddzhs
凝=dhpzphhpdzdzshpd
宁=ddzhs
拧=hshddzhs
泞=ddhddzhs
牛=phhs
扭=hshzshh
钮=phhhzzshh
纽=zzhzshh
脓=pzhhdzpzpd
浓=ddhdzpzpd
农=dzpzpd
弄=hhshhps
奴=zphzd
努=zphzdzp
怒=zphzddzdd
女=zph
暖=szhhpddphhpzd
虐=shzphzhzh
疟=dhpdhhzh
挪=hshzhhpzs
懦=ddshdzsddddhpszss
糯=dphspdhdzsddddhpszss
诺=dzhsshpszh
哦=szhphshzpd
欧=hpdzpzpd
鸥=hpdzpzdzh
殴=hpdzpzzd
藕=hsshhhspdszhhszshd
呕=szhhpdz
偶=psszhhszshd
沤=ddhhpdz
啪=szhhshpszhh
趴=szhshshpd
爬=ppsdzshz
帕=szspszhh
怕=ddspszhh
琶=hhshhhshzshz
拍=hshpszhh
排=hshshhhshhh
牌=pshzpszhhphs
徘=ppsshhhshhh
湃=ddhphhphhhhs
派=ddhpppzpd
攀=hspdpdpdhspdhpdphhs
潘=ddhpdphspdszhsh
盘=ppzdhdszssh
磐=ppzdhdpzzdhpszh
盼=szhhhpdzp
畔=szhshdphhs
判=dphhpss
叛=dphhpppzd
乓=pshshd
庞=dhphpzpd
旁=dhdpdzdhzp
耪=hhhspddhdpdzdhzp
胖=pzhhdphhs
抛=hshpzzp
咆=szhpzzhz
刨=pzzhzss
炮=dppdpzzhz
袍=dzspdpzzhz
跑=szhshshpzzhz
泡=ddhpzzhz
呸=szhhpsdh
胚=pzhhhpsdh
培=hshdhdphszh
裴=shhhshhhdhpzpd
赔=szpddhdphszh
陪=zsdhdphszh
配=hszpzhhzhz
佩=pspzhszs
沛=ddhhszs
喷=szhhshssszpd
盆=pdzpszssh
砰=hpszhhdphs
抨=hshhdphs
烹=dhszhzsdddd
澎=ddhhshszhdphppp
彭=hshszhdphppp
蓬=hsspzdhhhsdzd
棚=hspdpzhhpzhh
硼=hpszhpzhhpzhh
篷=phdphdpzdhhhsdzd
膨=pzhhhshszhdphppp
朋=pzhhpzhh
鹏=pzhhpzhhpzdzh
捧=hshhhhpdhhs
碰=hpszhdphssdph
坯=hshhpsdh
砒=hpszhhzpz
霹=hdzsddddzhpszhdhdphhs
批=hshhzpz
披=hshzpszd
劈=zhpszhdhdphhszp
琵=hhshhhshhzpz
毗=szhshhzpz
啤=szhpszhhphs
脾=pzhhpszhhphs
疲=dhpdhzpszd
皮=zpszd
匹=hpzz
痞=dhpdhhpsdszh
僻=pszhpszhdhdphhs
屁=zhphzpz
譬=zhpszhdhdphhsdhhhszh
篇=phdphddzhpszhss
偏=psdzhpszhss
片=pshz
骗=zzhdzhpszhss
飘=hszsshhhspdpzpd
漂=ddhhszsshhhspd
瓢=hszsshhhspdppzdd
票=hszsshhhspd
撇=hshdpszspdphpd
瞥=dpszspdphpdszhhh
拼=hshdphhps
频=shshspphpszpd
贫=pdzpszpd
品=szhszhszh
聘=hsshhhszhshhz
乒=pshshp
坪=hshhdphs
苹=hsshdphs
萍=hssddhhdphs
平=hdphs
凭=psphshpz
瓶=dphhpshzzd
评=dzhdphs
屏=zhpdphhps
坡=hshzpszd
泼=ddhzpzdd
颇=zpszdhpszpd
婆=ddhzpszdzph
破=hpszhzpszd
魄=pszhhpszhhpzzd
迫=pszhhdzd
粕=dphspdpszhh
剖=dhdphszhss
扑=hshsd
铺=phhhzhszhhsd
仆=pssd
莆=hsshszhhsd
葡=hsspzhszhhsd
菩=hssdhdphszh
蒲=hssddhhszhhsd
埔=hshhszhhsd
朴=hspdsd
圃=szhszhhsdh
普=dphssdphszhh
浦=ddhhszhhsd
谱=dzdphssdphszhh
曝=szhhszhhhsshpdsdhpd
瀑=ddhszhhhsshpdsdhpd
期=hsshhhpdpzhh
欺=hsshhhpdpzpd
栖=hspdhszpzh
戚=hpshhspdzpd
妻=hzhhszph
七=hz
凄=dhhzhhszph
漆=ddhhspdpdsdhpd
柒=ddhhzhspd
沏=ddhhzzp
其=hsshhhpd
棋=hspdhsshhhpd
奇=hpdhszhs
歧=shshhszd
畦=szhshhshhsh
崎=szshpdhszhs
脐=pzhhdhpdps
齐=dhpdps
旗=dhzpphhsshhhpd
祈=dzsdpphs
祁=dzsdzs
骑=zzhhpdhszhs
起=hshshpdzhz
岂=szszhz
乞=phz
企=pdshsh
启=dzhpszh
契=hhhszphpd
砌=hpszhhzzp
器=szhszhhpddszhszh
气=phhz
迄=phzdzd
弃=dhzdhps
汽=ddhphhz
泣=ddhdhdph
讫=dzphz
掐=hshpzpshzhh
恰=ddspdhszh
洽=ddhpdhszh
牵=hpddzphhs
扦=hshphs
钎=phhhzphs
铅=phhhzpzszh
千=phs
迁=phsdzd
签=phdphdpdhddph
仟=psphs
谦=dzdphzhhsspd
乾=hsszhhhsphz
黔=szdphshhddddpddz
钱=phhhzhhzpd
钳=phhhzhsshh
前=dphszhhss
潜=ddhhhpdhhpdszhh
遣=szhshszhzhdzd
浅=ddhhhzpd
谴=dzszhshszhzhdzd
堑=hzshpphshsh
嵌=szshsshhpzpd
欠=pzpd
歉=dphzhhsspdpzpd
枪=hspdpdzz
呛=szhpdzz
腔=pzhhddzpdhsh
羌=dphhhpz
墙=hshhsdphszszhh
蔷=hsshsdphszszhh
强=zhzszhszhshd
抢=hshpdzz
橇=hspdphhzphhzphhz
锹=phhhzphspddppd
敲=dhszhszszhshzd
悄=ddssdpszhh
桥=hspdphpdps
瞧=szhhhpsdhhhshdddd
乔=phpdps
侨=psphpdps
巧=hshhz
鞘=hsshszhhssdpszhh
撬=hshphhzphhzphhz
翘=hzphpzzdhzdh
峭=szssdpszhh
俏=pssdpszhh
窍=ddzpdhshhz
切=hzzp
茄=hsszpszh
且=szhhh
怯=ddshshzd
窃=ddzpdhzzp
钦=phhhzpzpd
侵=pszhhdzzd
亲=dhdphhspd
秦=hhhpdphspd
琴=hhshhhshpddz
勤=hsshszhhhshzp
芹=hsspphs
擒=hshpddhpdzsszzd
禽=pddhpdzsszzd
寝=ddzdhszhhdzzd
沁=ddhdzdd
青=hhshszhh
轻=hzshzdhsh
氢=phhzzdhsh
倾=pshzhpszpd
卿=pzpzhhzdzs
清=ddhhhshszhh
擎=hsspzszhphpdphhs
晴=szhhhhshszhh
氰=phhzhhshszhh
情=ddshhshszhh
顷=hzhpszpd
请=dzhhshszhh
庆=dhphpd
琼=hhshdhszhspd
穷=ddzpdzp
秋=phspddppd
丘=pshsh
邱=pshshzs
球=hhshhsdhpdd
求=hsdhpdd
囚=szpdh
酋=dphszpzhh
泅=ddhszpdh
趋=hshshpdpzzhh
区=hpdz
蛆=szhshdszhhh
曲=szhssh
躯=pszhhhphpdz
屈=zhpzsszs
驱=zzhhpdz
渠=ddhhzhzhspd
取=hsshhhzd
娶=hsshhhzdzph
龋=shshpdzspszhszshd
趣=hshshpdhsshhhzd
去=hshzd
圈=szdphhpdzzh
颧=hssszhszhpsdhhhshhpszpd
权=hspdzd
醛=hszpzhhhsspdhhsh
泉=pszhhszpd
全=pdhhsh
痊=dhpdhpdhhsh
拳=dphhpdphhs
犬=hpdd
券=dphhpdzp
劝=zdzp
缺=phhszszhpd
炔=dppdzhpd
瘸=dhpdhzpszhszpdpd
却=hshzdzs
鹊=hsshszhhpzdzh
榷=hspddzpsdhhhsh
确=hpszhpzpzhhs
雀=spdpsdhhhsh
裙=dzspdzhhpszh
群=zhhpszhdphhhs
然=pzddhpdddddd
燃=dppdpzddhpdddddd
冉=szshh
染=ddhpzhspd
瓤=dhszhszhhhsshpzpdppzdd
壤=hshdhszhszhhhsshpzpd
攘=hshdhszhszhhhsshpzpd
嚷=szhdhszhszhhhsshpzpd
让=dzshh
饶=pzzhzphpz
扰=hshhpzd
绕=zzhhzphpz
惹=hsshpszhdzdd
热=hshpzddddd
壬=phsh
仁=pshh
人=pd
忍=zpddzdd
韧=hhzszpd
任=psphsh
认=dzpd
刃=zpd
妊=zphphsh
纫=zzhzpd
扔=hshzp
仍=pszp
日=szhh
戎=hhpzpd
茸=hsshsshhh
蓉=hssddzpdpdszh
荣=hssdzhspd
融=hszhszdphsszhshd
熔=dppdddzpdpdszh
溶=ddhddzpdpdszh
容=ddzpdpdszh
绒=zzhhhpzpd
冗=dzpz
揉=hshzdzsphspd
柔=zdzsphspd
肉=szpdpd
茹=hsszphszh
蠕=szhshdhdzsddddhpszss
儒=pshdzsddddhpszss
孺=zshhdzsddddhpszss
如=zphszh
辱=hphhzpdhsd
乳=pddpzshz
汝=ddhzph
入=pd
褥=dzspdhphhzpdhsd
软=hzshpzpd
阮=zshhpz
蕊=hssdzdddzdddzdd
瑞=hhshszshpszss
锐=phhhzdpszhpz
闰=dszhhsh
润=ddhdszhhsh
若=hsshpszh
弱=zhzdhzhzdh
撒=hshhsshszhhphpd
洒=ddhhszpzh
萨=hsszsdhdphp
腮=pzhhszhshdzdd
鳃=pzszhshhszhshdzdd
塞=ddzhhsshpdhsh
赛=ddzhhsshpdszpd
三=hhh
叁=zdhpdhhh
伞=pddphs
散=hsshszhhphpd
桑=zdzdzdhspd
嗓=szhzdzdzdhspd
丧=hsdphzpd
搔=hshzddszhshd
骚=zzhzddszhshd
扫=hshzhh
嫂=zphpshzhhszd
瑟=hhshhhshdzdpd
色=pzzshz
涩=ddhzpdshsh
森=hspdhspdhspd
僧=psdpszsdphszhh
莎=hssddhspdp
砂=hpszhspdp
杀=pdhspd
刹=pdhspdss
沙=ddhspdp
纱=zzhspdp
傻=pspszpdhpdpzd
啥=szhpdhhsszh
煞=pzzhhphpddddd
筛=phdphdsphszs
晒=szhhhszpzh
珊=hhshpzpzh
苫=hssshszh
杉=hspdppp
山=szs
删=pzpzhss
煽=dppddzhpzdhzdh
衫=dzspdppp
闪=dszpd
陕=zshdphpd
擅=hshdhszszhhszhhh
赡=szpdpzhppddhhhszh
膳=pzhhdphhhsdphszh
善=dphhhsdphszh
汕=ddhszs
扇=dzhpzdhzdh
缮=zzhdphhhsdphszh
墒=hshdhdpszpdszh
伤=psphzp
商=dhdpszpdszh
赏=sdpdzszhszpd
晌=szhhpszszh
上=shh
尚=sdpszszh
裳=sdpdzszhdhpzpd
梢=hspdsdpszhh
捎=hshsdpszhh
稍=phspdsdpszhh
烧=dppdhzphpz
芍=hsspzd
勺=pzd
韶=dhdphszhhzpszh
少=spdp
哨=szhsdpszhh
邵=zpszhzs
绍=zzhzpszh
奢=hpdhshpszhh
赊=szpdpdhhspd
蛇=szhshdddzpz
舌=phsszh
舍=pdhhsszh
赦=hshpspdphpd
摄=hshhsshhhzdzd
射=pszhhhphsd
慑=ddshsshhhzdzd
涉=ddhshshspp
社=dzsdhsh
设=dzpzzd
砷=hpszhszhhs
申=szhhs
呻=szhszhhs
伸=psszhhs
身=pszhhhp
深=ddhdzpdhspd
娠=zphhphhzpd
绅=zzhszhhs
神=dzsdszhhs
沈=ddhdzpz
审=ddzszhhs
婶=zphddzszhhs
甚=hsshhhpdz
肾=sszdszhh
慎=ddshsszhhhhpd
渗=ddhzdhpdppp
声=hshzshp
生=phhsh
甥=phhshszhshzp
牲=phshphhsh
升=phps
绳=zzhszhszhhz
省=spdpszhhh
盛=hpzzpdszssh
剩=phsshhpzpdss
胜=pzhhphhsh
圣=zdhsh
师=sphszs
失=phhpd
狮=pzpsphszs
施=dhzpphzsz
湿=ddhszhhssdph
诗=dzhshhsd
尸=zhp
虱=zpszhshd
十=hs
石=hpszh
拾=hshpdhszh
时=szhhhsd
什=pshs
食=pddzhhzpd
蚀=pzzszhshd
实=ddzddhpd
识=dzszhpd
史=szhpd
矢=phhpd
使=pshszhpd
屎=zhpdphspd
驶=zzhszhpd
始=zphzdszh
式=hhshzd
示=hhspd
士=hsh
世=hsshz
柿=hspddhszs
事=hszhzhhs
拭=hshhhshzd
誓=hshpphsdhhhszh
逝=hshpphsdzd
势=hshpzdzp
是=szhhhshpd
嗜=szhhshppzszhh
噬=szhphdphdhspdpdh
适=phsszhdzd
仕=pshsh
侍=pshshhsd
释=pdphspdzdhhs
饰=pzzphszs
氏=pzhz
市=dhszs
恃=ddshshhsd
室=ddzhzdhsh
视=dzsdszpz
试=dzhhshzd
收=zsphpd
手=phhs
首=dphpszhhh
守=ddzhsd
寿=hhhphsd
授=hshpddpdzzd
售=psdhhhshszh
受=pddpdzzd
瘦=dhpdhpshzhhszd
兽=dpszhshhszh
蔬=hsszshshdhzdpsz
枢=hspdhpdz
梳=hspddhzdpsz
殊=hpzdphhspd
抒=hshzdzs
输=hzshpdhszhhss
叔=shhspdzd
舒=pdhhsszhzdzs
淑=ddhshhspdzd
疏=zshshdhzdpsz
书=zzsd
赎=szpdhszddhpd
孰=dhszhzshpzd
熟=dhszhzshpzddddd
薯=hssszsshhshpszhh
暑=szhhhshpszhh
曙=szhhszsshhshpszhh
署=szsshhshpszhh
蜀=szsshpzszhshd
黍=phspdpdsdhpd
鼠=pshzhhzddzddz
属=zhppszhszshd
术=hspdd
述=hspdddzd
树=hspdzdhsd
束=hszhspd
戍=hpdzpd
竖=sszddhdph
墅=szhhshhzdzshsh
庶=dhphsshdddd
数=dphspdzphphpd
漱=ddhhszhspdpzpd
恕=zphszhdzdd
刷=zhpszsss
耍=hpszsszph
摔=hshdhzzddhpdhs
衰=dhszhhpzpd
甩=pzhhz
帅=spszs
栓=hspdpdhhsh
拴=hshpdhhsh
霜=hdzsddddhspdszhhh
双=zdzd
爽=hpdpdpdpdpd
谁=dzpsdhhhsh
水=szpd
睡=szhhhphshsshh
税=phspddpszhpz
吮=szhzdpz
瞬=szhhhpddpdzpzdhzs
顺=psshpszpd
舜=pddpdzpzdhzs
说=dzdpszhpz
硕=hpszhhpszpd
朔=dphzsppzhh
烁=dppdpzspd
斯=hsshhhpdpphs
撕=hshhsshhhpdpphs
嘶=szhhsshhhpdpphs
思=szhshdzdd
私=phspdzd
司=zhszh
丝=zzzzh
死=hpzdpz
肆=hshhhzdzhhhhs
寺=hshhsd
嗣=szhszhsszhszh
四=szpzh
伺=pszhszh
似=pszdpd
饲=pzzzhszh
巳=zhz
松=hspdpdzd
耸=pdpdhsshhh
怂=pdpddzdd
颂=pdzdhpszpd
送=dphhpddzd
宋=ddzhspd
讼=dzpdzd
诵=dzzdszhhs
搜=hshpshzhhszd
艘=ppzdhdpshzhhszd
擞=hshdphspdzphphpd
嗽=szhhszhspdpzpd
苏=hsszpdd
酥=hszpzhhphspd
俗=pspdpdszh
素=hhshzzdspd
速=hszhspddzd
粟=hszsshdphspd
僳=pshszsshdphspd
塑=dphzsppzhhhsh
溯=ddhdphzsppzhh
宿=ddzpshpszhh
诉=dzpphsd
肃=zhhspspd
酸=hszpzhhzdpdpzd
蒜=hsshhspdhhspd
算=phdphdszhhhhps
虽=szhszhshd
隋=zshphshszhh
随=zshpszhhdzd
绥=zzhpddpzph
髓=szzdzszhhhphshszhhdzd
碎=hpszhdhpdpdhs
岁=szspzd
穗=phspdhszhhshddzdd
遂=dphpzpppddzd
隧=zsdphpzpppddzd
祟=zsszshhspd
孙=zshspd
损=hshszhszpd
笋=phdphdzhhp
蓑=hssdhszhhpzpd
梭=hspdzdpdpzd
唆=szhzdpdpzd
缩=zzhddzpshpszhh
琐=hhshsdpszpd
索=hsdzzzdspd
锁=phhhzsdpszpd
所=ppzhpphs
塌=hshszhhzdhzdh
他=pszsz
它=ddzpz
她=zphzsz
塔=hshhsspdhszh
獭=pzphszhspdpzszpd
挞=hshhpddzd
蹋=szhshshszhhzdhzdh
踏=szhshshszpdszhh
胎=pzhhzdszh
苔=hsszdszh
抬=hshzdszh
台=zdszh
泰=hhhpdsdhpd
酞=hszpzhhhpdd
太=hpdd
态=hpdddzdd
汰=ddhhpdd
坍=hshpzdh
摊=hshzdpsdhhhsh
贪=pddzszpd
瘫=dhpdhzdpsdhhhsh
滩=ddhzdpsdhhhsh
坛=hshhhzd
檀=hspddhszszhhszhhh
痰=dhpdhdppddppd
潭=ddhhszsshszhhhs
谭=dzhszsshszhhhs
谈=dzdppddppd
坦=hshszhhh
毯=phhzdppddppd
袒=dzspdszhhh
碳=hpszhszshpdppd
探=hshdzpdhspd
叹=szhzd
炭=szshpdppd
汤=ddhzpp
塘=hshdhpzhhsszh
搪=hshdhpzhhsszh
堂=sdpdzszhhsh
棠=sdpdzszhhspd
膛=pzhhsdpdzszhhsh
唐=dhpzhhsszh
糖=dphspddhpzhhsszh
倘=pssdpszszh
躺=pszhhhpsdpszszh
淌=ddhsdpszszh
趟=hshshpdsdpszszh
烫=ddhzppdppd
掏=hshpzphhszs
涛=ddhhhhphsd
滔=ddhpddppshzhh
绦=zzhpzdhspd
萄=hsspzphhszs
桃=hspdpdhzpd
逃=pdhzpddzd
淘=ddhpzphhszs
陶=zspzphhszs
讨=dzhsd
套=hpdhshhhzd
特=phshhshhsd
藤=hsspzhhdphhpdsdhpd
腾=pzhhdphhpdzzh
疼=dhpdhpzddd
誊=dphhpddhhhszh
梯=hspddpzhzsp
剔=szhhpzppss
踢=szhshshszhhpzpp
锑=phhhzdpzhzsp
提=hshszhhhshpd
题=szhhhshpdhpszpd
蹄=szhshshdhdpdzszs
啼=szhdhdpdzszs
体=pshspdh
替=hhpdhhpdszhh
嚏=szhhsdzszhshzshsd
惕=ddsszhhpzpp
涕=ddhdpzhzsp
剃=dpzhzspss
屉=zhphsshz
天=hhpd
添=ddhhhpdsddd
填=hshhsszhhhhpd
田=szhsh
甜=phsszhhsshh
恬=ddsphsszh
舔=phsszhhhpdsddd
腆=pzhhszhsshpd
挑=hshpdhzpd
条=pzdhspd
迢=zpszhdzd
眺=szhhhpdhzpd
跳=szhshshpdhzpd
贴=szpdshszh
铁=phhhzphhpd
帖=szsshszh
厅=hphs
听=szhpphs
烃=dppdzdhsh
汀=ddhhs
廷=phshzd
停=psdhszhdzhs
亭=dhszhdzhs
庭=dhpphshzd
挺=hshphshzd
艇=ppzdhdphshzd
通=zdszhhsdzd
桐=hspdszhszh
酮=hszpzhhszhszh
瞳=szhhhdhdphszhhshh
同=szhszh
铜=phhhzszhszh
彤=pzdhppp
童=dhdphszhhshh
桶=hspdzdszhhs
捅=hshzdszhhs
筒=phdphdszhszh
统=zzhdhzdpz
痛=dhpdhzdszhhs
偷=pspdhszhhss
投=hshpzzd
头=ddhpd
透=phspdzpdzd
凸=shszh
秃=phspdpz
突=ddzpdhpdd
图=szpzdddh
徒=ppshshshpd
途=pdhhspddzd
涂=ddhpdhhspd
屠=zhphshpszhh
土=hsh
吐=szhhsh
兔=pzszhpzd
湍=ddhszshpszss
团=szhsph
推=hshpsdhhhsh
颓=phspdpzhpszpd
腿=pzhhzhhzpddzd
蜕=szhshddpszhpz
褪=dzspdzhhzpddzd
退=zhhzpddzd
吞=hhpdszh
屯=hzsz
臀=zhphsshpdpzzdszhh
拖=hshphzsz
托=hshphz
脱=pzhhdpszhpz
鸵=pzdzhddzpz
陀=zsddzpz
驮=zzhhpd
驼=zzhddzpz
椭=hspdzshpszhh
妥=pddpzph
拓=hshhpszh
唾=szhphshsshh
挖=hshddzpdz
哇=szhhshhsh
蛙=szhshdhshhsh
洼=ddhhshhsh
娃=zphhshhsh
瓦=hzzd
袜=dzspdhhspd
歪=hpsdhshsh
外=pzdsd
豌=hszhdphddzpzdzz
弯=dhsspdzhz
湾=ddhdhsspdzhz
玩=hhshhhpz
顽=hhpzhpszpd
丸=pzd
烷=dppdddzhhpz
完=ddzhhpz
碗=hpszhddzpzdzz
挽=hshpzszhpz
晚=szhhpzszhpz
皖=pszhhddzhhpz
惋=ddsddzpzdzz
宛=ddzpzdzz
婉=zphddzpzdzz
万=hzp
腕=pzhhddzpzdzz
汪=ddhhhsh
王=hhsh
亡=dhz
枉=hspdhhsh
网=szpdpd
往=ppsdhhsh
旺=szhhhhsh
望=dhzpzhhhhsh
忘=dhzdzdd
妄=dhzzph
威=hphzphzpd
巍=szsphspdzphpszhhpzzd
微=ppsszshpzphpd
危=pzhpzz
韦=hhzs
违=hhzsdzd
桅=hspdpzhpzz
围=szhhzsh
唯=szhpsdhhhsh
惟=ddspsdhhhsh
为=dpzd
潍=ddhzzhpsdhhhsh
维=zzhpsdhhhsh
苇=hsshhzs
萎=hssphspdzph
委=phspdzph
伟=pshhzs
伪=psdpzd
尾=zhpphhz
纬=zzhhhzs
未=hhspd
蔚=hsszhphhspdhsd
味=szhhhspd
畏=szhshhzpd
胃=szhshszhh
喂=szhszhshhzpd
魏=phspdzphpszhhpzzd
位=psdhdph
渭=ddhszhshszhh
谓=dzszhshszhh
尉=zhphhspdhsd
慰=zhphhspdhsddzdd
卫=zsh
瘟=dhpdhszhhszssh
温=ddhszhhszssh
蚊=szhshddhpd
文=dhpd
闻=dszhsshhh
纹=zzhdhpd
吻=szhpzpp
稳=phspdpzzhhdzdd
紊=dhpdzzdspd
问=dszszh
嗡=szhpdzdzdhzdh
翁=pdzdzdhzdh
瓮=pdzdhzzd
挝=hshhsddzd
蜗=szhshdszhszpd
涡=ddhszhszpd
窝=ddzpdszhszpd
我=phshzpd
斡=hsszhhhspdddhs
卧=hszhszsd
握=hshzhphzdhsh
沃=ddhphpd
巫=hspdpdh
呜=szhpzzh
钨=phhhzpzzh
乌=pzzh
污=ddhhhz
诬=dzhspdpdh
屋=zhphzdhsh
无=hhpz
芜=hsshhpz
梧=hspdhszhszh
吾=hszhszh
吴=szhhhpd
毋=zzph
武=hhshshzd
五=hszh
捂=hshhszhszh
午=phhs
舞=phhsssshpzdhzs
伍=pshszh
侮=psphzzdhd
坞=hshpzzh
戊=hpzpd
雾=hdzsddddpzdzp
晤=szhhhszhszh
物=phshpzpp
勿=pzpp
务=pzdzp
悟=ddshszhszh
误=dzszhhhpd
昔=hsshszhh
熙=hsszhszzhzdddd
析=hspdpphs
西=hszpzh
硒=hpszhhszpzh
矽=hpszhpzd
晰=szhhhspdpphs
嘻=szhhshszhdphszh
吸=szhpzd
锡=phhhzszhhpzpp
牺=phshhszpzh
稀=phspdpdhpszs
息=pszhhhdzdd
希=pdhpszs
悉=pdphspddzdd
膝=pzhhhspdpdsdhpd
夕=pzd
惜=ddshsshszhh
熄=dppdpszhhhdzdd
烯=dppdpdhpszs
溪=ddhpddpzzdhpd
汐=ddhpzd
犀=zhpsdhpdphhs
檄=hspdpszhhdhzpphpd
袭=hpzpddhpzpd
席=dhphsshszs
习=zdh
媳=zphpszhhhdzdd
喜=hshszhdphszh
铣=phhhzphshpz
洗=ddhphshpz
系=pzzdspd
隙=zsspdszhhspd
戏=zdhzpd
细=zzhszhsh
瞎=szhhhddzhhhsszh
虾=szhshdhsd
匣=hszhhsz
霞=hdzsddddzhshhzhzd
辖=hzshddzhhhsszh
暇=szhhzhshhzhzd
峡=szshdphpd
侠=pshdphpd
狭=pzphdphpd
下=hsd
厦=hphpszhhhpzd
夏=hpszhhhpzd
吓=szhhsd
掀=hshpphspzpd
锨=phhhzpphspzpd
先=phshpz
仙=psszs
鲜=pzszhshhdphhhs
纤=zzhphs
咸=hphszhzpd
贤=sszdszpd
衔=ppsphhhzhhs
舷=ppzdhddhzzd
闲=dszhspd
涎=ddhpshzzd
弦=zhzdhzzd
嫌=zphdphzhhsspd
显=szhhssdph
险=zspdhddph
现=hhshszpz
献=hsszdphhshpdd
县=szhhhzd
腺=pzhhpszhhszpd
馅=pzzpzpshzhh
羡=dphhshdhpzpd
宪=ddzphshpz
陷=zspzpshzhh
限=zszhhzpd
线=zzhhhzpd
相=hspdszhhh
厢=hphspdszhhh
镶=phhhzdhszhszhhhsshpzpd
香=phspdszhh
箱=phdphdhspdszhhh
襄=dhszhszhhhsshpzpd
湘=ddhhspdszhhh
乡=zzp
翔=dphhhpzdhzdh
祥=dzsddphhhs
详=dzdphhhs
想=hspdszhhhdzdd
响=szhpszszh
享=dhszhzsh
项=hshhpszpd
巷=hsshpdzhz
橡=hspdpzszhpzpppd
像=pspzszhpzpppd
向=pszszh
象=pzszhpzpppd
萧=hsszhhspspd
硝=hpszhsdpszhh
霄=hdzsddddsdpszhh
削=sdpszhhss
哮=szhhshpzsh
嚣=szhszhhpszpdszhszh
销=phhhzsdpszhh
消=ddhsdpszhh
宵=ddzsdpszhh
淆=ddhpdhpszhh
晓=szhhhzphpz
小=spd
孝=hshpzsh
校=hspddhpdpd
肖=sdpszhh
啸=szhzhhspspd
笑=phdphdphpd
效=dhpdpdphpd
楔=hspdhhhszphpd
些=shshpzhh
歇=szhhpzpdzpzpd
蝎=szhshdszhhpzpdz
鞋=hsshszhhshshhsh
协=hszpdd
挟=hshhdphpd
携=hshpsdhhhshzp
邪=hzspzs
斜=pdhhspdddhs
胁=pzhhzpdd
谐=dzhzpzpszhh
写=dzhzh
械=hspdhhpszpd
卸=phhshshzs
蟹=pzpzhhszpphhsszhshd
懈=ddspzpzhhszpphhs
泄=ddhhsshz
泻=ddhdzhzh
谢=dzpszhhhphsd
屑=zhpsdpszhh
薪=hssdhdphhspdpphs
芯=hssdzdd
锌=phhhzdhdphhs
欣=pphspzpd
辛=dhdphhs
新=dhdphhspdpphs
忻=ddspphs
心=dzdd
信=psdhhhszh
衅=pszsshdphhs
星=szhhphhsh
腥=pzhhszhhphhsh
猩=pzpszhhphhsh
惺=ddsszhhphhsh
兴=ddphpd
刑=hhpsss
型=hhpssshsh
形=hhpsppp
邢=hhpszs
行=ppshhs
醒=hszpzhhszhhphhsh
幸=hshdphhs
杏=hspdszh
性=ddsphhsh
姓=zphphhsh
兄=szhpz
凶=pdzs
胸=pzhhpzpdzs
匈=pzpdzs
汹=ddhpdzs
雄=hpzdpsdhhhsh
熊=zdszhhpzpzdddd
休=pshspd
修=psspzdppp
羞=dphhhpzshh
朽=hspdhz
嗅=szhpszhhhhpdd
锈=phhhzphspdzp
秀=phspdzp
袖=dzspdszhsh
绣=zzhphspdzp
墟=hshshzphzssdph
戌=hphzpd
需=hdzsddddhpszss
虚=shzphzssdph
嘘=szhshzphzssdph
须=ppphpszpd
徐=ppspdhhspd
许=dzphhs
蓄=hssdhzzdszhsh
酗=hszpzhhpdzs
叙=pdhhspdzd
旭=pzszhh
序=dhpzdzs
畜=dhzzdszhsh
恤=ddspszssh
絮=zphszhzzdspd
婿=zphzshpdszhh
绪=zzhhshpszhh
续=zzhhszddhpd
轩=hzshhhs
喧=szhddzhszhhh
宣=ddzhszhhh
悬=szhhhzddzdd
旋=dhzpphzshpd
玄=dhzzd
选=phshpzdzd
癣=dhpdhpzszhshhdphhhs
眩=szhhhdhzzd
绚=zzhpzszhh
靴=hsshszhhspspz
薛=hsspszhzhdhdphhs
学=ddpdzzsh
穴=ddzpd
雪=hdzsddddzhh
血=pszssh
勋=szhszpdzp
熏=phszdphshhdddd
循=ppspphsszhhh
旬=pzszhh
询=dzpzszhh
寻=zhhhsd
驯=zzhpss
巡=zzzdzd
殉=hpzdpzszhh
汛=ddhzhs
训=dzpss
讯=dzzhs
逊=zshspddzd
迅=zhsdzd
压=hphshd
押=hshszhhs
鸦=hzsppzdzh
鸭=szhhspzdzh
呀=szhhzsp
丫=dps
芽=hsshzsp
牙=hzsp
蚜=szhshdhzsp
崖=szshphshhsh
衙=ppshszhszhhhs
涯=ddhhphshhsh
雅=hzsppsdhhhsh
哑=szhhssdph
亚=hssdph
讶=dzhzsp
焉=hshshhzdddd
咽=szhszhpdh
阉=dszhpdszhhz
烟=dppdszhpdh
淹=ddhhpdszhhz
盐=hshsdszssh
严=hssdphp
研=hpszhhhps
蜒=szhshdpshzzd
岩=szshpszh
延=pshzzd
言=dhhhszh
颜=dhdphpppphpszpd
阎=dszpzpshzhh
炎=dppddppd
沿=ddhpzszh
奄=hpdszhhz
掩=hshhpdszhhz
眼=szhhhzhhzpd
衍=ppsddhhhs
演=ddhddzhszhshpd
艳=hhhspzzshz
堰=hshhszhhzphz
燕=hsshszhshhpzdddd
厌=hphpdd
砚=hpszhszpz
雁=hppspsdhhhsh
唁=szhdhhhszh
彦=dhdphpppp
焰=dppdpzpshzhh
宴=ddzszhhzph
谚=dzdhdphpppp
验=zzhpdhddph
殃=hpzdszhpd
央=szhpd
鸯=szhpdpzdzh
秧=phspdszhpd
杨=hspdzpp
扬=hshzpp
佯=psdphhhs
疡=dhpdhzpp
羊=dphhhs
洋=ddhdphhhs
阳=zsszhh
氧=phhzdphhhs
仰=pspzzs
痒=dhpdhdphhhs
养=dphhhpdps
样=hspddphhhs
漾=ddhdphhshdzzpd
邀=pszhhdhzpphpddzd
腰=pzhhhszsshzph
妖=zphphpd
瑶=hhshpddpphhszs
摇=hshpddpphhszs
尧=hzphpz
遥=pddpphhszsdzd
窑=ddzpdphhszs
谣=dzpddpphhszs
姚=zphpdhzpd
咬=szhdhpdpd
舀=pddppshzhh
药=hsszzhpzd
要=hszsshzph
耀=sdphpzzdhzdhpsdhhhsh
椰=hspdhsshhhzs
噎=szhhshdzhszhdph
耶=hsshhhzs
爷=pdpdzs
野=szhhshhzdzs
冶=dhzdszh
也=zsz
页=hpszpd
掖=hshdhpspzdd
业=ssdph
叶=szhhs
曳=szhhzp
腋=pzhhdhpspzdd
夜=dhpspzdd
液=ddhdhpspzdd
一=h
壹=hshdzhszhdph
医=hphhpdz
揖=hshszhhsshhh
铱=phhhzdhpzpd
依=psdhpzpd
伊=pszhhp
衣=dhpzpd
颐=hsszhszhpszpd
夷=hzhzpd
遗=szhshszpddzd
移=phspdpzdpzd
仪=psdpd
胰=pzhhhzhzpd
疑=pzphhpdzdzshpd
沂=ddhpphs
宜=ddzszhhh
姨=zphhzhzpd
彝=zzhdphspdzzdspdhps
椅=hspdhpdhszhs
蚁=szhshddpd
倚=pshpdhszhs
已=zhz
乙=z
矣=zdphhpd
以=zdpd
艺=hssz
抑=hshpzzs
易=szhhpzpp
邑=szhzshz
屹=szsphz
亿=psz
役=ppspzzd
臆=pzhhdhdphszhhdzdd
逸=pzszhpzddzd
肄=pzphhpdzhhhhs
疫=dhpdhpzzd
亦=dhpspd
裔=dhpzpdszpdszh
意=dhdphszhhdzdd
毅=dhdphpzpppdpzzd
忆=ddsz
义=dpd
益=dphpdszssh
溢=ddhdphpdszssh
诣=dzpzszhh
议=dzdpd
谊=dzddzszhhh
译=dzzdhhs
异=zhzhps
翼=zdhzdhszhshhsshpd
翌=zdhzdhdhdph
绎=zzhzdhhs
茵=hssszhpdh
荫=hsszspzhh
因=szhpdh
殷=ppzhhzpzzd
音=dhdphszhh
阴=zspzhh
姻=zphszhpdh
吟=szhpddz
银=phhhzzhhzpd
淫=ddhpddpphsh
寅=ddzhszhshpd
饮=pzzpzpd
尹=zhhp
引=zhzs
隐=zspzzhhdzdd
印=pzhzs
英=hssszhpd
樱=hspdszpdszpdzph
婴=szpdszpdzph
鹰=dhppspsdhhhshpzdzh
应=dhpddph
缨=zzhszpdszpdzph
莹=hssdzhhshd
萤=hssdzszhshd
营=hssdzszhszh
荧=hssdzdppd
蝇=szhshdszhszhhz
迎=pzzsdzd
赢=dhzszhpzhhszpdpzd
盈=zpzdszssh
影=szhhdhszhspdppp
颖=pzphspdhpszpd
硬=hpszhhszhhpd
映=szhhszhpd
哟=szhzzhpzd
拥=hshpzhhs
佣=pspzhhs
臃=pzhhdhzzppsdhhhsh
痈=dhpdhpzhhs
庸=dhpzhhszhhs
雍=dhzzppsdhhhsh
踊=szhshshzdszhhs
蛹=szhshdzdszhhs
咏=szhdzzpd
泳=ddhdzzpd
涌=ddhzdszhhs
永=dzzpd
恿=zdszhhsdzdd
勇=zdszhhszp
用=pzhhs
幽=szzdzzdzs
优=pshpzd
悠=pssphpddzdd
忧=ddshpzd
尤=hpzd
由=szhsh
邮=szhshzs
铀=phhhzszhsh
犹=pzphpzd
油=ddhszhsh
游=ddhdhzpphzsh
酉=hszpzhh
有=hpszhh
友=hpzd
右=hpszh
佑=pshpszh
釉=pdphspdszhsh
诱=dzphspdzp
又=zd
幼=zzdzp
迂=hhsdzd
淤=ddhdhzppddd
于=hhs
盂=hhsszssh
榆=hspdpdhszhhss
虞=shzphzszhhhpd
愚=szhhszshddzdd
舆=pshhhzhszhhhpd
余=pdhhspd
俞=pdhszhhss
逾=pdhszhhssdzd
鱼=pzszhshh
愉=ddspdhszhhss
渝=ddhpdhszhhss
渔=ddhpzszhshh
隅=zsszhhszshd
予=zdzs
娱=zphszhhhpd
雨=hszsdddd
与=hzh
屿=szshzh
禹=pszhszshd
宇=ddzhhs
语=dzhszhszh
羽=zdhzdh
玉=hhshd
域=hshhszhhzpd
芋=hsshhs
郁=hpszhhzs
吁=szhhhs
遇=szhhszshddzd
喻=szhpdhszhhss
峪=szspdpdszh
御=ppsphhshshzs
愈=pdhszhhssdzdd
欲=pdpdszhpzpd
狱=pzpdzhpdd
育=dhzdszhh
誉=ddphpddhhhszh
浴=ddhpdpdszh
寓=ddzszhhszshd
裕=dzspdpdpdszh
预=zdzshpszpd
豫=zdzspzszhpzpppd
驭=zzhzd
鸳=pzdzzpzdzh
渊=ddhpdphspds
冤=dzpzszhpzd
元=hhpz
垣=hshhszhhh
袁=hshszhpzpd
原=hppszhhspd
援=hshpddphhpzd
辕=hzshhshszhpzpd
园=szhhpzh
员=szhszpd
圆=szszhszpdh
猿=pzphshszhpzpd
源=ddhhppszhhspd
缘=zzhzzhpzpppd
远=hhpzdzd
苑=hsspzdzz
愿=hppszhhspddzdd
怨=pzdzzdzdd
院=zsddzhhpz
曰=szhh
约=zzhpzd
越=hshshpdhzzpd
跃=szhshshphpd
钥=phhhzpzhh
岳=pshshszs
粤=pszdphspdhhz
月=pzhh
悦=ddsdpszhpz
阅=dszdpszhpz
耘=hhhspdhhzd
云=hhzd
郧=szhszpdzs
匀=pzdh
陨=zsszhszpd
允=zdpz
运=hhzddzd
蕴=hsszzhszhhszssh
酝=hszpzhhhhzd
晕=szhhdzhzhs
韵=dhdphszhhpzdh
孕=zpzsh
匝=hszsz
砸=hpszhhszsz
杂=pzhspd
栽=hshhspdzpd
哉=hshszhzpd
灾=ddzdppd
宰=ddzdhdphhs
载=hshhzshzpd
再=hszshh
在=hpshsh
咱=szhpszhhh
攒=hshphshpzphshpzszpd
暂=hzshpphsszhh
赞=phshpzphshpzszpd
赃=szpddhphsh
脏=pzhhdhphsh
葬=hsshpzdpzhps
遭=hszhsshszhhdzd
糟=dphspdhszhsshszhh
凿=ssdphdphhszs
藻=hssddhszhszhszhhspd
枣=hszspddd
早=szhhhs
澡=ddhszhszhszhhspd
蚤=zddszhshd
躁=szhshshszhszhszhhspd
噪=szhszhszhszhhspd
造=phshszhdzd
皂=pszhhhz
灶=dppdhsh
燥=dppdszhszhszhhspd
责=hhshszpd
择=hshzdhhs
则=szpdss
泽=ddhzdhhs
贼=szpdhhpzpd
怎=phshhdzdd
增=hshdpszsdphszhh
憎=ddsdpszsdphszhh
曾=dpszsdphszhh
赠=szpddpszsdphszhh
扎=hshz
喳=szhhspdszhhh
渣=ddhhspdszhhh
札=hspdz
轧=hzshz
铡=phhhzszpdss
闸=dszszhhs
眨=szhhhpdzd
栅=hspdpzpzh
榨=hspdddzpdphshh
咋=szhphshh
乍=phshh
炸=dppdphshh
诈=dzphshh
摘=hshdhdpszhsszh
斋=dhpdhpszss
宅=ddzphz
窄=ddzpdphshh
债=pshhshszpd
寨=ddzhhsshpdhspd
瞻=szhhhpzhppddhhhszh
毡=phhzshszh
詹=pzhppddhhhszh
粘=dphspdshszh
沾=ddhshszh
盏=hhzpdszssh
斩=hzshpphs
辗=hzshzhphsshzpd
崭=szshzshpphs
展=zhphsshzpd
蘸=hsshszpzhhpsdhhhshdddd
栈=hspdhhzpd
占=shszh
战=shszhhzpd
站=dhdphshszh
湛=ddhhsshhhpdz
绽=zzhddzhshpd
樟=hspddhdphszhhhs
章=dhdphszhhhs
彰=dhdphszhhhsppp
漳=ddhdhdphszhhhs
张=zhzphzd
掌=sdpdzszhphhs
涨=ddhzhzphzd
杖=hspdhpd
丈=hpd
帐=szsphzd
账=szpdphzd
仗=pshpd
胀=pzhhphzd
瘴=dhpdhdhdphszhhhs
障=zsdhdphszhhhs
招=hshzpszh
昭=szhhzpszh
找=hshhzpd
沼=ddhzpszh
赵=hshshpdpd
照=szhhzpszhdddd
罩=szsshshszhhhs
兆=pdhzpd
肇=dzhpphpdzhhhhs
召=zpszh
遮=dhphsshdddddzd
折=hshpphs
哲=hshpphsszh
蛰=hshpzdszhshd
辙=hzshdhzdszhhphpd
者=hshpszhh
锗=phhhzhshpszhh
蔗=hssdhphsshdddd
这=dhpddzd
浙=ddhhshpphs
珍=hhshpdppp
斟=hsshhhpdzddhs
真=hsszhhhhpd
甄=hszsshhshhzzd
砧=hpszhshszh
臻=hzdhshhhhpdphspd
贞=shszpd
针=phhhzhs
侦=psshszpd
枕=hspddzpz
疹=dhpdhpdppp
诊=dzpdppp
震=hdzsddddhphhzpd
振=hshhphhzpd
镇=phhhzhsszhhhhpd
阵=zshzhs
蒸=hsszszpdhdddd
挣=hshpzzhhs
睁=szhhhpzzhhs
征=ppshshsh
狰=pzppzzhhs
争=pzzhhs
怔=ddshshsh
整=hszhspdphpdhshsh
拯=hshzszpdh
正=hshsh
政=hshshphpd
帧=szsshszpd
症=dhpdhhshsh
郑=dphhpdzs
证=dzhshsh
芝=hssdzd
枝=hspdhszd
支=hszd
吱=szhhszd
蜘=szhshdphhpdszh
知=phhpdszh
肢=pzhhhszd
脂=pzhhpzszhh
汁=ddhhs
之=dzd
织=zzhszhpd
职=hsshhhszhpd
直=hsszhhhh
植=hspdhsszhhhh
殖=hpzdhsszhhhh
执=hshpzd
值=pshsszhhhh
侄=pshzdhsh
址=hshshsh
指=hshpzszhh
止=shsh
趾=szhshshshsh
只=szhpd
旨=pzszhh
纸=zzhpzhz
志=hshdzdd
挚=hshpzdphhs
掷=hshdphhpdzs
至=hzdhsh
致=hzdhshphpd
置=szsshhsszhhhh
帜=szsszhpd
峙=szshshhsd
制=phhszsss
智=phhpdszhszhh
秩=phspdphhpd
稚=phspdpsdhhhsh
质=pphsszpd
炙=pzdddppd
痔=dhpdhhshhsd
滞=ddhhsssdzszs
治=ddhzdszh
窒=ddzpdhzdhsh
中=szhs
盅=szhsszssh
忠=szhsdzdd
钟=phhhzszhs
衷=dhszhspzpd
终=zzhpzddd
种=phspdszhs
肿=pzhhszhs
重=phszhhshh
仲=psszhs
众=pdpdpd
舟=ppzdhd
周=pzhshszh
州=dpdsds
洲=ddhdpdsds
诌=dzpzzhh
粥=zhzdphspdzhz
轴=hzshszhsh
肘=pzhhhsd
帚=zhhdzszs
咒=szhszhpz
皱=pzzhhzpszd
宙=ddzszhsh
昼=zhpdszhhh
骤=zzhhsshhhzdpspppd
珠=hhshphhspd
株=hspdphhspd
蛛=szhshdphhspd
朱=phhspd
猪=pzphshpszhh
诸=dzhshpszhh
诛=dzphhspd
逐=hpzpppddzd
竹=phsphs
烛=dppdszhshd
煮=hshpszhhdddd
拄=hshdhhsh
瞩=szhhhzhppszhszshd
嘱=szhzhppszhszshd
主=dhhsh
著=hsshshpszhh
柱=hspddhhsh
助=szhhhzp
蛀=szhshddhhsh
贮=szpdddzh
铸=phhhzhhhphsd
筑=phdphdhshpzd
住=psdhhsh
注=ddhdhhsh
祝=dzsdszhpz
驻=zzhdhhsh
抓=hshppsd
爪=ppsd
拽=hshszhhzp
专=hhzd
砖=hpszhhhzd
转=hzshhhzd
撰=hshzhzzhzhsshpd
赚=szpddphzhhsspd
篆=phdphdzzhpzpppd
桩=hspddhphsh
庄=dhphsh
装=dhshshdhpzpd
妆=dhszph
撞=hshdhdphszhhshh
壮=dhshsh
状=dhshpdd
椎=hspdpsdhhhsh
锥=phhhzpsdhhhsh
追=pszhzhdzd
赘=hhshzpphpdszpd
坠=zspdhsh
缀=zzhzdzdzdzd
谆=dzdhszhzsh
准=dhpsdhhhsh
捉=hshszhshpd
拙=hshzsszs
卓=shszhhhs
桌=shszhhhspd
琢=hhshhpzppdpd
茁=hsszsszs
酌=hszpzhhpzd
啄=szhhpzppdpd
着=dphhhpszhhh
灼=dppdpzd
浊=ddhszhshd
兹=dphzzdzzd
咨=dhpzpdszh
资=dhpzpdszpd
姿=dhpzpdzph
滋=ddhdphzzdzzd
淄=ddhzzzszhsh
孜=zshphpd
紫=shshpzzzdspd
仔=pszsh
籽=dphspdzsh
滓=ddhddzdhdphhs
子=zsh
自=pszhhh
渍=ddhhhshszpd
字=ddzzsh
鬃=hshhhzdpppddzhhspd
棕=hspdddzhhspd
踪=szhshshddzhhspd
宗=ddzhhspd
综=zzhddzhhspd
总=dpszhdzdd
纵=zzhpdpd
邹=pzzhhzs
走=hshshpd
奏=hhhpdhhpd
揍=hshhhhpdhhpd
租=phspdszhhh
足=szhshpd
卒=dhpdpdhs
族=dhzpphphhpd
祖=dzsdszhhh
诅=dzszhhh
阻=zsszhhh
组=zzhszhhh
钻=phhhzshszh
纂=phdphdszhhhhpdzzdspd
嘴=szhshshpzpzpzhhs
醉=hszpzhhdhpdpdhs
最=szhhhsshhhzd
罪=szsshshhhshhh
尊=dphszpzhhhsd
遵=dphszpzhhhsddzd
昨=szhhphshh
左=hphsh
佐=pshphsh
柞=hspdphshh
做=pshsszhphpd
作=psphshh
坐=pdpdhsh
座=dhppdpdhsh
